Id,Balance,Amount,Currency,Type,Status,Modified,Trade Id,Instrument Symbol,Instrument Name,Commission,Account type
"75311057400111","16172.09","4.66","EURd","TRADE","PROCESSED","2024-10-12 20:50:31","0015421d-0055-311e-0000-4e28000a8aa4_0015421d-0055-311e-0000-000081309791","ETH/USD","Ethereum / USD","",""
"75228612009516","16167.43","27.25","EURd","TRADE","PROCESSED","2024-10-11 23:00:05","0015421d-0055-311e-0000-4e27000f5dab_0015421d-0055-311e-0000-00008130874f","ETH/USD","Ethereum / USD","",""
"75228609912363","16140.18","59.51","EURd","TRADE","PROCESSED","2024-10-11 23:00:03","000940dd-0055-311e-0000-4e27000c75a8_000940dd-0055-311e-0000-0000822ad8a4","BTC/USD","Bitcoin / USD","",""
"75024240385766","16080.67","12.89","EURd","TRADE","PROCESSED","2024-10-09 16:51:41","00001344-0055-311e-0000-4e25000e876d_00001344-0055-311e-0000-0000804d0c79","AMD","Advanced Micro Devices Inc (Extended Hours)","",""
"75024238288608","16067.78","25.09","EURd","TRADE","PROCESSED","2024-10-09 16:51:39","00001344-0055-311e-0000-4e25000e8746_00001344-0055-311e-0000-0000804d1161","AMD","Advanced Micro Devices Inc (Extended Hours)","",""
"75024236191448","16042.69","3.04","EURd","TRADE","PROCESSED","2024-10-09 16:51:37","00353194-0055-311e-0000-4e25000e86fa_00353194-0055-311e-0000-00008050045a","MSFT","Microsoft Corp (Extended Hours)","",""
"75024234094291","16039.65","13.98","EURd","TRADE","PROCESSED","2024-10-09 16:51:35","0004d68e-0055-311e-0000-4e25000e869d_0004d68e-0055-311e-0000-000080550b2f","AMZN","Amazon.com Inc (Extended Hours)","",""
"74843390386094","16025.67","9.09","EURd","TRADE","PROCESSED","2024-10-07 16:57:09","0015421d-0055-311e-0000-4e23000f6d28_0015421d-0055-311e-0000-000081306265","ETH/USD","Ethereum / USD","",""
"74843388288936","16016.58","23.99","EURd","TRADE","PROCESSED","2024-10-07 16:57:07","000144cd-0055-311e-0000-4e2300199f99_000144cd-0055-311e-0000-0000809001d7","TSM","Taiwan Semiconductor Manufacturing Co Ltd - ADR (Extended Hours)","",""
"74843387240349","15992.59","53.71","EURd","TRADE","PROCESSED","2024-10-07 16:57:06","00396101-0055-311e-0000-4e23000ded2a_00396101-0055-311e-0000-0000805927b6","NVDA","NVIDIA Corp (Extended Hours)","",""
"74815683898468","15938.88","44.51","EURd","TRADE","PROCESSED","2024-10-07 09:36:46","000940dd-0055-311e-0000-4e2300056164_000940dd-0055-311e-0000-000082296d02","BTC/USD","Bitcoin / USD","",""
"74815683898467","15894.37","46.44","EURd","TRADE","PROCESSED","2024-10-07 09:36:46","000940dd-0055-311e-0000-4e2300056163_000940dd-0055-311e-0000-000082294e29","BTC/USD","Bitcoin / USD","",""
"74465727882611","15847.93","39.03","EURd","TRADE","PROCESSED","2024-10-03 12:54:22","00018509-0055-311e-0000-4e1f000bfd5b_00018509-0055-311e-0000-000081ad987e","Oil - Crude","Crude Oil","",""
"74410883219786","15808.9","-4.98","EURd","TRADE","PROCESSED","2024-10-02 22:22:38","00396101-0055-311e-0000-4e1e00163924_00396101-0055-311e-0000-000080563dd6","NVDA","NVIDIA Corp (Extended Hours)","",""
"74410883219785","15813.88","32.04","EURd","TRADE","PROCESSED","2024-10-02 22:22:38","00396101-0055-311e-0000-4e1e00163923_00396101-0055-311e-0000-000080590cd0","NVDA","NVIDIA Corp (Extended Hours)","",""
"74314386962274","15781.84","37.22","EURd","TRADE","PROCESSED","2024-10-01 20:48:52","00081081-0055-311e-0000-4e1d001d9402_00081081-0055-311e-0000-0000804d04b0","BABA","Alibaba Group Holding Limited (Extended Hours)","",""
"74314363893504","15744.62","12.47","EURd","TRADE","PROCESSED","2024-10-01 20:48:30","00018509-0055-311e-0000-4e1d0028479b_00018509-0055-311e-0000-000081a96dc0","Oil - Crude","Crude Oil","",""
"74314363893502","15732.15","47.48","EURd","TRADE","PROCESSED","2024-10-01 20:48:30","00018509-0055-311e-0000-4e1d0028479a_00018509-0055-311e-0000-000081a9a116","Oil - Crude","Crude Oil","",""
"74314363893501","15684.67","55.41","EURd","TRADE","PROCESSED","2024-10-01 20:48:30","00018509-0055-311e-0000-4e1d00284799_00018509-0055-311e-0000-000081a9c3b8","Oil - Crude","Crude Oil","",""
"73836497435260","15629.26","6.85","EURd","TRADE","PROCESSED","2024-09-26 14:13:01","0015421d-0055-311e-0000-4e18000fb1d5_0015421d-0055-311e-0000-0000812cff1d","ETH/USD","Ethereum / USD","",""
"73836497435259","15622.41","6.81","EURd","TRADE","PROCESSED","2024-09-26 14:13:01","0015421d-0055-311e-0000-4e18000fb1d4_0015421d-0055-311e-0000-0000812cff1b","ETH/USD","Ethereum / USD","",""
"73771832785107","15615.6","0.31","EURd","SWAP","PROCESSED","2024-09-25 21:05:12","","Oil - Crude","Crude Oil","",""
"73743501348599","15615.29","8.84","EURd","TRADE","PROCESSED","2024-09-25 13:34:53","00001344-0055-311e-0000-4e17000265d6_00001344-0055-311e-0000-000080474949","AMD","Advanced Micro Devices Inc (Extended Hours)","",""
"73743290580551","15606.45","12.54","EURd","TRADE","PROCESSED","2024-09-25 13:31:32","00513301-0055-311e-0000-4e1700076a6d_00513301-0055-311e-0000-000080cbeaaa","TSLA","Tesla Inc (Extended Hours)","",""
"73738635912999","15593.91","5.49","EURd","TRADE","PROCESSED","2024-09-25 12:17:33","0004d68e-0055-311e-0000-4e1700018648_0004d68e-0055-311e-0000-000080462057","AMZN","Amazon.com Inc (Extended Hours)","",""
"73738635912998","15588.42","5.58","EURd","TRADE","PROCESSED","2024-09-25 12:17:33","0004d68e-0055-311e-0000-4e1700018647_0004d68e-0055-311e-0000-000080462055","AMZN","Amazon.com Inc (Extended Hours)","",""
"73738633815835","15582.84","32.6","EURd","TRADE","PROCESSED","2024-09-25 12:17:31","00396101-0055-311e-0000-4e1700018637_00396101-0055-311e-0000-000080532a1f","NVDA","NVIDIA Corp (Extended Hours)","",""
"73419192526072","15550.24","11.61","EURd","TRADE","PROCESSED","2024-09-21 23:40:08","0015421d-0055-311e-0000-4e13000fd964_0015421d-0055-311e-0000-0000812b2f8e","ETH/USD","Ethereum / USD","",""
"73207470270256","15538.63","32.08","EURd","TRADE","PROCESSED","2024-09-19 15:34:54","00001344-0055-311e-0000-4e11000da4f8_00001344-0055-311e-0000-0000804a3b28","AMD","Advanced Micro Devices Inc (Extended Hours)","",""
"73207425181062","15506.55","16.09","EURd","TRADE","PROCESSED","2024-09-19 15:34:11","0015421d-0055-311e-0000-4e11001f465a_0015421d-0055-311e-0000-0000812bba7c","ETH/USD","Ethereum / USD","",""
"73207420986699","15490.46","55.86","EURd","TRADE","PROCESSED","2024-09-19 15:34:07","0015421d-0055-311e-0000-4e11001f4593_0015421d-0055-311e-0000-0000812c6b34","ETH/USD","Ethereum / USD","",""
"72499049139220","15434.6","34.31","EURd","TRADE","PROCESSED","2024-09-11 19:54:51","000144cd-0055-311e-0000-4e090033f54c_000144cd-0055-311e-0000-0000808a0193","TSM","Taiwan Semiconductor Manufacturing Co Ltd - ADR (Extended Hours)","",""
"72474859574867","15400.29","31.59","EURd","TRADE","PROCESSED","2024-09-11 13:30:22","00396101-0055-311e-0000-4e0900039208_00396101-0055-311e-0000-00008052bb09","NVDA","NVIDIA Corp (Extended Hours)","",""
"71965241148193","15368.7","-18.45","EURd","TRADE","PROCESSED","2024-09-05 22:30:12","00018387-0055-311e-0000-4e0300306be6_00018387-0055-311e-0000-0000812578a3","Natural Gas","Natural Gas","",""
"71965241148192","15387.15","7.65","EURd","TRADE","PROCESSED","2024-09-05 22:30:12","00018387-0055-311e-0000-4e0300306be5_00018387-0055-311e-0000-000081257bbd","Natural Gas","Natural Gas","",""
"71965241148191","15379.5","17.1","EURd","TRADE","PROCESSED","2024-09-05 22:30:12","00018387-0055-311e-0000-4e0300306be4_00018387-0055-311e-0000-000081280ece","Natural Gas","Natural Gas","",""
"71959951136082","15362.4","-5.76","EURd","SWAP","PROCESSED","2024-09-05 21:06:07","","Natural Gas","Natural Gas","",""
"71959950086536","15368.16","-5.76","EURd","SWAP","PROCESSED","2024-09-05 21:06:06","","Natural Gas","Natural Gas","",""
"71959949034510","15373.92","-5.76","EURd","SWAP","PROCESSED","2024-09-05 21:06:05","","Natural Gas","Natural Gas","",""
"71918056370541","15379.68","20.37","EURd","TRADE","PROCESSED","2024-09-05 10:00:13","00513301-0055-311e-0000-4e030007d93c_00513301-0055-311e-0000-000080c6a3ab","TSLA","Tesla Inc (Extended Hours)","",""
"71918056370540","15359.31","66.12","EURd","TRADE","PROCESSED","2024-09-05 10:00:13","00513301-0055-311e-0000-4e030007d93b_00513301-0055-311e-0000-000080c93a73","TSLA","Tesla Inc (Extended Hours)","",""
"71869358328957","15293.19","-5.58","EURd","SWAP","PROCESSED","2024-09-04 21:06:11","","Natural Gas","Natural Gas","",""
"71869358328913","15298.77","-5.58","EURd","SWAP","PROCESSED","2024-09-04 21:06:11","","Natural Gas","Natural Gas","",""
"71869358328835","15304.35","-5.58","EURd","SWAP","PROCESSED","2024-09-04 21:06:11","","Natural Gas","Natural Gas","",""
"71778755116560","15309.93","-5.6","EURd","SWAP","PROCESSED","2024-09-03 21:06:05","","Natural Gas","Natural Gas","",""
"71778755116481","15315.53","-5.6","EURd","SWAP","PROCESSED","2024-09-03 21:06:05","","Natural Gas","Natural Gas","",""
"71778755116408","15321.13","-5.6","EURd","SWAP","PROCESSED","2024-09-03 21:06:05","","Natural Gas","Natural Gas","",""
"71688137159448","15326.73","-5.62","EURd","SWAP","PROCESSED","2024-09-02 21:05:45","","Natural Gas","Natural Gas","",""
"71688137159362","15332.35","-5.62","EURd","SWAP","PROCESSED","2024-09-02 21:05:45","","Natural Gas","Natural Gas","",""
"71688137159292","15337.97","-5.62","EURd","SWAP","PROCESSED","2024-09-02 21:05:45","","Natural Gas","Natural Gas","",""
"71597537086295","15343.59","-6.08","EURd","SWAP","PROCESSED","2024-09-01 21:05:42","","Natural Gas","Natural Gas","",""
"71597537086261","15349.67","-6.08","EURd","SWAP","PROCESSED","2024-09-01 21:05:42","","Natural Gas","Natural Gas","",""
"71597537086214","15355.75","-6.08","EURd","SWAP","PROCESSED","2024-09-01 21:05:42","","Natural Gas","Natural Gas","",""
"71506984088271","15361.83","-6.08","EURd","SWAP","PROCESSED","2024-08-31 21:06:24","","Natural Gas","Natural Gas","",""
"71506984088213","15367.91","-6.08","EURd","SWAP","PROCESSED","2024-08-31 21:06:24","","Natural Gas","Natural Gas","",""
"71506984088169","15373.99","-6.08","EURd","SWAP","PROCESSED","2024-08-31 21:06:24","","Natural Gas","Natural Gas","",""
"71416373565261","15380.07","-6.12","EURd","SWAP","PROCESSED","2024-08-30 21:06:11","","Natural Gas","Natural Gas","",""
"71416373565153","15386.19","-6.12","EURd","SWAP","PROCESSED","2024-08-30 21:06:11","","Natural Gas","Natural Gas","",""
"71416373565042","15392.31","-6.12","EURd","SWAP","PROCESSED","2024-08-30 21:06:11","","Natural Gas","Natural Gas","",""
"71325761885395","15398.43","-6.68","EURd","SWAP","PROCESSED","2024-08-29 21:05:57","","Natural Gas","Natural Gas","",""
"71325761885325","15405.11","-6.68","EURd","SWAP","PROCESSED","2024-08-29 21:05:57","","Natural Gas","Natural Gas","",""
"71325761885278","15411.79","-6.68","EURd","SWAP","PROCESSED","2024-08-29 21:05:57","","Natural Gas","Natural Gas","",""
"71235199563326","15418.47","-6.64","EURd","SWAP","PROCESSED","2024-08-28 21:06:30","","Natural Gas","Natural Gas","",""
"71235199563289","15425.11","-6.64","EURd","SWAP","PROCESSED","2024-08-28 21:06:30","","Natural Gas","Natural Gas","",""
"71235199563253","15431.75","-6.64","EURd","SWAP","PROCESSED","2024-08-28 21:06:30","","Natural Gas","Natural Gas","",""
"71144607814124","15438.39","-6.58","EURd","SWAP","PROCESSED","2024-08-27 21:06:35","","Natural Gas","Natural Gas","",""
"71144607814090","15444.97","-6.58","EURd","SWAP","PROCESSED","2024-08-27 21:06:35","","Natural Gas","Natural Gas","",""
"71144607814053","15451.55","-6.58","EURd","SWAP","PROCESSED","2024-08-27 21:06:35","","Natural Gas","Natural Gas","",""
"71053997182562","15458.13","-6.32","EURd","SWAP","PROCESSED","2024-08-26 21:06:22","","Natural Gas","Natural Gas","",""
"71053997182453","15464.45","-6.32","EURd","SWAP","PROCESSED","2024-08-26 21:06:22","","Natural Gas","Natural Gas","",""
"71053997182358","15470.77","-6.32","EURd","SWAP","PROCESSED","2024-08-26 21:06:22","","Natural Gas","Natural Gas","",""
"70963343537122","15477.09","-2.33","EURd","SWAP","PROCESSED","2024-08-25 21:05:28","","Natural Gas","Natural Gas","",""
"70963343537060","15479.42","-2.33","EURd","SWAP","PROCESSED","2024-08-25 21:05:28","","Natural Gas","Natural Gas","",""
"70963343537000","15481.75","-2.33","EURd","SWAP","PROCESSED","2024-08-25 21:05:28","","Natural Gas","Natural Gas","",""
"70872810527552","15484.08","-2.33","EURd","SWAP","PROCESSED","2024-08-24 21:06:29","","Natural Gas","Natural Gas","",""
"70872810527516","15486.41","-2.33","EURd","SWAP","PROCESSED","2024-08-24 21:06:29","","Natural Gas","Natural Gas","",""
"70872810527466","15488.74","-2.33","EURd","SWAP","PROCESSED","2024-08-24 21:06:29","","Natural Gas","Natural Gas","",""
"70782167451619","15491.07","-2.33","EURd","SWAP","PROCESSED","2024-08-23 21:05:45","","Natural Gas","Natural Gas","",""
"70782167451554","15493.4","-2.33","EURd","SWAP","PROCESSED","2024-08-23 21:05:45","","Natural Gas","Natural Gas","",""
"70782167451494","15495.73","-2.33","EURd","SWAP","PROCESSED","2024-08-23 21:05:45","","Natural Gas","Natural Gas","",""
"70691532790244","15498.06","-2.22","EURd","SWAP","PROCESSED","2024-08-22 21:05:09","","Natural Gas","Natural Gas","",""
"70691532790167","15500.28","-2.22","EURd","SWAP","PROCESSED","2024-08-22 21:05:09","","Natural Gas","Natural Gas","",""
"70691532790116","15502.5","-2.22","EURd","SWAP","PROCESSED","2024-08-22 21:05:09","","Natural Gas","Natural Gas","",""
"70658168150997","15504.72","5.84","EURd","TRADE","PROCESSED","2024-08-22 12:14:50","000144cd-0055-311e-0000-4df5000933cc_000144cd-0055-311e-0000-000080870534","TSM","Taiwan Semiconductor Manufacturing Co Ltd - ADR (Extended Hours)","",""
"70658166053840","15498.88","11.16","EURd","TRADE","PROCESSED","2024-08-22 12:14:48","0015421d-0055-311e-0000-4df5000b263d_0015421d-0055-311e-0000-000081280851","ETH/USD","Ethereum / USD","",""
"70658163956679","15487.72","15.99","EURd","TRADE","PROCESSED","2024-08-22 12:14:46","00513301-0055-311e-0000-4df50006cbcd_00513301-0055-311e-0000-000080c67374","TSLA","Tesla Inc (Extended Hours)","",""
"70654314615634","15471.73","35.37","EURd","TRADE","PROCESSED","2024-08-22 11:13:35","00396101-0055-311e-0000-4df50001ca18_00396101-0055-311e-0000-00008048958e","NVDA","NVIDIA Corp (Extended Hours)","",""
"70654314615630","15436.36","17.96","EURd","TRADE","PROCESSED","2024-08-22 11:13:35","00396101-0055-311e-0000-4df50001ca17_00396101-0055-311e-0000-000080488d6f","NVDA","NVIDIA Corp (Extended Hours)","",""
"70600931659420","15418.4","-2.14","EURd","SWAP","PROCESSED","2024-08-21 21:05:05","","Natural Gas","Natural Gas","",""
"70600931659380","15420.54","-2.14","EURd","SWAP","PROCESSED","2024-08-21 21:05:05","","Natural Gas","Natural Gas","",""
"70600931659319","15422.68","-2.14","EURd","SWAP","PROCESSED","2024-08-21 21:05:05","","Natural Gas","Natural Gas","",""
"70510334584360","15424.82","-1.99","EURd","SWAP","PROCESSED","2024-08-20 21:05:05","","Natural Gas","Natural Gas","",""
"70510334584313","15426.81","-1.99","EURd","SWAP","PROCESSED","2024-08-20 21:05:05","","Natural Gas","Natural Gas","",""
"70510334584248","15428.8","-1.99","EURd","SWAP","PROCESSED","2024-08-20 21:05:05","","Natural Gas","Natural Gas","",""
"70419790069613","15430.79","-1.98","EURd","SWAP","PROCESSED","2024-08-19 21:05:55","","Natural Gas","Natural Gas","",""
"70419790069555","15432.77","-1.98","EURd","SWAP","PROCESSED","2024-08-19 21:05:55","","Natural Gas","Natural Gas","",""
"70419790069483","15434.75","-1.98","EURd","SWAP","PROCESSED","2024-08-19 21:05:55","","Natural Gas","Natural Gas","",""
"70329185750571","15436.73","-2.02","EURd","SWAP","PROCESSED","2024-08-18 21:05:48","","Natural Gas","Natural Gas","",""
"70329185750530","15438.75","-2.02","EURd","SWAP","PROCESSED","2024-08-18 21:05:48","","Natural Gas","Natural Gas","",""
"70329185750483","15440.77","-2.02","EURd","SWAP","PROCESSED","2024-08-18 21:05:48","","Natural Gas","Natural Gas","",""
"70238573146324","15442.79","-2.02","EURd","SWAP","PROCESSED","2024-08-17 21:05:33","","Natural Gas","Natural Gas","",""
"70238573146271","15444.81","-2.02","EURd","SWAP","PROCESSED","2024-08-17 21:05:33","","Natural Gas","Natural Gas","",""
"70238573146188","15446.83","-2.02","EURd","SWAP","PROCESSED","2024-08-17 21:05:33","","Natural Gas","Natural Gas","",""
"70147967778209","15448.85","-2.02","EURd","SWAP","PROCESSED","2024-08-16 21:05:25","","Natural Gas","Natural Gas","",""
"70147967778150","15450.87","-2.02","EURd","SWAP","PROCESSED","2024-08-16 21:05:25","","Natural Gas","Natural Gas","",""
"70147967778068","15452.89","-2.02","EURd","SWAP","PROCESSED","2024-08-16 21:05:25","","Natural Gas","Natural Gas","",""
"70147034513285","15454.91","27.52","EURd","TRADE","PROCESSED","2024-08-16 20:50:35","000144cd-0055-311e-0000-4def001ec24b_000144cd-0055-311e-0000-00008087038e","TSM","Taiwan Semiconductor Manufacturing Co Ltd - ADR (Extended Hours)","",""
"70147032416128","15427.39","44.21","EURd","TRADE","PROCESSED","2024-08-16 20:50:33","0004d68e-0055-311e-0000-4def00114a81_0004d68e-0055-311e-0000-0000804c1f61","AMZN","Amazon.com Inc (Extended Hours)","",""
"70057358257888","15383.18","-1.92","EURd","SWAP","PROCESSED","2024-08-15 21:05:13","","Natural Gas","Natural Gas","",""
"70057358257830","15385.1","-1.92","EURd","SWAP","PROCESSED","2024-08-15 21:05:13","","Natural Gas","Natural Gas","",""
"70057358257767","15387.02","-1.92","EURd","SWAP","PROCESSED","2024-08-15 21:05:13","","Natural Gas","Natural Gas","",""
"69966759076233","15388.94","-2.03","EURd","SWAP","PROCESSED","2024-08-14 21:05:11","","Natural Gas","Natural Gas","",""
"69966759076130","15390.97","-2.03","EURd","SWAP","PROCESSED","2024-08-14 21:05:11","","Natural Gas","Natural Gas","",""
"69966759076033","15393","-2.03","EURd","SWAP","PROCESSED","2024-08-14 21:05:11","","Natural Gas","Natural Gas","",""
"69876231361432","15395.03","-2.31","EURd","SWAP","PROCESSED","2024-08-13 21:06:17","","Natural Gas","Natural Gas","",""
"69876230312788","15397.34","-2.31","EURd","SWAP","PROCESSED","2024-08-13 21:06:16","","Natural Gas","Natural Gas","",""
"69876230312745","15399.65","-2.31","EURd","SWAP","PROCESSED","2024-08-13 21:06:16","","Natural Gas","Natural Gas","",""
"69785571443680","15401.96","-2.3","EURd","SWAP","PROCESSED","2024-08-12 21:05:17","","Natural Gas","Natural Gas","",""
"69785571443586","15404.26","-2.3","EURd","SWAP","PROCESSED","2024-08-12 21:05:17","","Natural Gas","Natural Gas","",""
"69785571443530","15406.56","-2.3","EURd","SWAP","PROCESSED","2024-08-12 21:05:17","","Natural Gas","Natural Gas","",""
"69773026344707","15408.86","18.11","EURd","TRADE","PROCESSED","2024-08-12 17:45:53","00001344-0055-311e-0000-4deb000efcbb_00001344-0055-311e-0000-0000804713b8","AMD","Advanced Micro Devices Inc (Extended Hours)","",""
"69773007470255","15390.75","24.97","EURd","TRADE","PROCESSED","2024-08-12 17:45:35","00081081-0055-311e-0000-4deb000efa41_00081081-0055-311e-0000-000080410528","BABA","Alibaba Group Holding Limited (Extended Hours)","",""
"69695038526343","15365.78","-2.33","EURd","SWAP","PROCESSED","2024-08-11 21:06:18","","Natural Gas","Natural Gas","",""
"69695038526320","15368.11","-2.33","EURd","SWAP","PROCESSED","2024-08-11 21:06:18","","Natural Gas","Natural Gas","",""
"69695038526295","15370.44","-2.33","EURd","SWAP","PROCESSED","2024-08-11 21:06:18","","Natural Gas","Natural Gas","",""
"69604403734897","15372.77","-2.33","EURd","SWAP","PROCESSED","2024-08-10 21:05:42","","Natural Gas","Natural Gas","",""
"69604403734824","15375.1","-2.33","EURd","SWAP","PROCESSED","2024-08-10 21:05:42","","Natural Gas","Natural Gas","",""
"69604402686168","15377.43","-2.33","EURd","SWAP","PROCESSED","2024-08-10 21:05:41","","Natural Gas","Natural Gas","",""
"69513845552653","15379.76","-2.34","EURd","SWAP","PROCESSED","2024-08-09 21:06:19","","Natural Gas","Natural Gas","",""
"69513845552618","15382.1","-2.34","EURd","SWAP","PROCESSED","2024-08-09 21:06:19","","Natural Gas","Natural Gas","",""
"69513845552574","15384.44","-2.34","EURd","SWAP","PROCESSED","2024-08-09 21:06:19","","Natural Gas","Natural Gas","",""
"69423176288246","15386.78","-2.08","EURd","SWAP","PROCESSED","2024-08-08 21:05:10","","Natural Gas","Natural Gas","",""
"69423176288200","15388.86","-2.08","EURd","SWAP","PROCESSED","2024-08-08 21:05:10","","Natural Gas","Natural Gas","",""
"69423176288160","15390.94","-2.08","EURd","SWAP","PROCESSED","2024-08-08 21:05:10","","Natural Gas","Natural Gas","",""
"69332601397776","15393.02","-1.88","EURd","SWAP","PROCESSED","2024-08-07 21:05:31","","Natural Gas","Natural Gas","",""
"69332601397682","15394.9","-1.88","EURd","SWAP","PROCESSED","2024-08-07 21:05:31","","Natural Gas","Natural Gas","",""
"69332601397611","15396.78","-1.88","EURd","SWAP","PROCESSED","2024-08-07 21:05:31","","Natural Gas","Natural Gas","",""
"69308000636181","15398.66","19.92","EURd","TRADE","PROCESSED","2024-08-07 14:34:30","00000182-0055-311e-0000-4de6000c871c_00000182-0055-311e-0000-000080741474","META","Meta Platforms Inc (Extended Hours)","",""
"69242029495299","15378.74","-1.77","EURd","SWAP","PROCESSED","2024-08-06 21:05:55","","Natural Gas","Natural Gas","",""
"69242029495236","15380.51","-1.77","EURd","SWAP","PROCESSED","2024-08-06 21:05:55","","Natural Gas","Natural Gas","",""
"69242029495131","15382.28","-1.77","EURd","SWAP","PROCESSED","2024-08-06 21:05:55","","Natural Gas","Natural Gas","",""
"69151393753256","15384.05","-1.7","EURd","SWAP","PROCESSED","2024-08-05 21:05:18","","Natural Gas","Natural Gas","",""
"69151393753194","15385.75","-1.7","EURd","SWAP","PROCESSED","2024-08-05 21:05:18","","Natural Gas","Natural Gas","",""
"69151393753140","15387.45","-1.7","EURd","SWAP","PROCESSED","2024-08-05 21:05:18","","Natural Gas","Natural Gas","",""
"69060787360302","15389.15","-2.03","EURd","SWAP","PROCESSED","2024-08-04 21:05:09","","Natural Gas","Natural Gas","",""
"69060787360230","15391.18","-2.03","EURd","SWAP","PROCESSED","2024-08-04 21:05:09","","Natural Gas","Natural Gas","",""
"69060787360041","15393.21","-2.03","EURd","SWAP","PROCESSED","2024-08-04 21:05:09","","Natural Gas","Natural Gas","",""
"68970190350509","15395.24","-2.03","EURd","SWAP","PROCESSED","2024-08-03 21:05:09","","Natural Gas","Natural Gas","",""
"68970190350464","15397.27","-2.03","EURd","SWAP","PROCESSED","2024-08-03 21:05:09","","Natural Gas","Natural Gas","",""
"68970190350328","15399.3","-2.03","EURd","SWAP","PROCESSED","2024-08-03 21:05:09","","Natural Gas","Natural Gas","",""
"68879597694321","15401.33","-2.04","EURd","SWAP","PROCESSED","2024-08-02 21:05:13","","Natural Gas","Natural Gas","",""
"68879597694263","15403.37","-2.04","EURd","SWAP","PROCESSED","2024-08-02 21:05:13","","Natural Gas","Natural Gas","",""
"68879597694073","15405.41","-2.04","EURd","SWAP","PROCESSED","2024-08-02 21:05:13","","Natural Gas","Natural Gas","",""
"68788994337270","15407.45","-1.88","EURd","SWAP","PROCESSED","2024-08-01 21:05:07","","Natural Gas","Natural Gas","",""
"68788994337208","15409.33","-1.88","EURd","SWAP","PROCESSED","2024-08-01 21:05:07","","Natural Gas","Natural Gas","",""
"68788994337086","15411.21","-1.88","EURd","SWAP","PROCESSED","2024-08-01 21:05:07","","Natural Gas","Natural Gas","",""
"68698394297146","15413.09","-1.87","EURd","SWAP","PROCESSED","2024-07-31 21:05:04","","Natural Gas","Natural Gas","",""
"68698394297101","15414.96","-1.87","EURd","SWAP","PROCESSED","2024-07-31 21:05:04","","Natural Gas","Natural Gas","",""
"68698394296943","15416.83","-1.87","EURd","SWAP","PROCESSED","2024-07-31 21:05:04","","Natural Gas","Natural Gas","",""
"68694656079893","15418.7","19.77","EURd","TRADE","PROCESSED","2024-07-31 20:05:39","00000182-0055-311e-0000-4ddf000f5a34_00000182-0055-311e-0000-000080740f95","META","Meta Platforms Inc (Extended Hours)","",""
"68607797318887","15398.93","-2","EURd","SWAP","PROCESSED","2024-07-30 21:05:04","","Natural Gas","Natural Gas","",""
"68607797318786","15400.93","-2","EURd","SWAP","PROCESSED","2024-07-30 21:05:04","","Natural Gas","Natural Gas","",""
"68607797318640","15402.93","-2","EURd","SWAP","PROCESSED","2024-07-30 21:05:04","","Natural Gas","Natural Gas","",""
"68517204566957","15404.93","-2.13","EURd","SWAP","PROCESSED","2024-07-29 21:05:08","","Natural Gas","Natural Gas","",""
"68517204566820","15407.06","-2.13","EURd","SWAP","PROCESSED","2024-07-29 21:05:08","","Natural Gas","Natural Gas","",""
"68517204566689","15409.19","-2.13","EURd","SWAP","PROCESSED","2024-07-29 21:05:08","","Natural Gas","Natural Gas","",""
"68426604349068","15411.32","-0.65","EURd","SWAP","PROCESSED","2024-07-28 21:05:05","","Natural Gas","Natural Gas","",""
"68426604348903","15411.97","-0.65","EURd","SWAP","PROCESSED","2024-07-28 21:05:05","","Natural Gas","Natural Gas","",""
"68426603300186","15412.62","-0.65","EURd","SWAP","PROCESSED","2024-07-28 21:05:04","","Natural Gas","Natural Gas","",""
"68336025330408","15413.27","-0.65","EURd","SWAP","PROCESSED","2024-07-27 21:05:22","","Natural Gas","Natural Gas","",""
"68336025330268","15413.92","-0.65","EURd","SWAP","PROCESSED","2024-07-27 21:05:22","","Natural Gas","Natural Gas","",""
"68336025330139","15414.57","-0.65","EURd","SWAP","PROCESSED","2024-07-27 21:05:22","","Natural Gas","Natural Gas","",""
"68245429378848","15415.22","-0.65","EURd","SWAP","PROCESSED","2024-07-26 21:05:23","","Natural Gas","Natural Gas","",""
"68245429378717","15415.87","-0.65","EURd","SWAP","PROCESSED","2024-07-26 21:05:23","","Natural Gas","Natural Gas","",""
"68245429378605","15416.52","-0.65","EURd","SWAP","PROCESSED","2024-07-26 21:05:23","","Natural Gas","Natural Gas","",""
"68154816706436","15417.17","-0.65","EURd","SWAP","PROCESSED","2024-07-25 21:05:08","","Natural Gas","Natural Gas","",""
"68154816706301","15417.82","-0.65","EURd","SWAP","PROCESSED","2024-07-25 21:05:08","","Natural Gas","Natural Gas","",""
"68154816706136","15418.47","-0.65","EURd","SWAP","PROCESSED","2024-07-25 21:05:08","","Natural Gas","Natural Gas","",""
"68064237531547","15419.12","-0.73","EURd","SWAP","PROCESSED","2024-07-24 21:05:25","","Natural Gas","Natural Gas","",""
"68064237531408","15419.85","-0.73","EURd","SWAP","PROCESSED","2024-07-24 21:05:25","","Natural Gas","Natural Gas","",""
"68064237531125","15420.58","-0.73","EURd","SWAP","PROCESSED","2024-07-24 21:05:25","","Natural Gas","Natural Gas","",""
"67973690902371","15421.31","-0.59","EURd","SWAP","PROCESSED","2024-07-23 21:06:13","","Natural Gas","Natural Gas","",""
"67973690902296","15421.9","-0.59","EURd","SWAP","PROCESSED","2024-07-23 21:06:13","","Natural Gas","Natural Gas","",""
"67973690902124","15422.49","-0.59","EURd","SWAP","PROCESSED","2024-07-23 21:06:13","","Natural Gas","Natural Gas","",""
"67883041448177","15423.08","-0.59","EURd","SWAP","PROCESSED","2024-07-22 21:05:23","","Natural Gas","Natural Gas","",""
"67883041448065","15423.67","-0.59","EURd","SWAP","PROCESSED","2024-07-22 21:05:23","","Natural Gas","Natural Gas","",""
"67883041447869","15424.26","-0.59","EURd","SWAP","PROCESSED","2024-07-22 21:05:23","","Natural Gas","Natural Gas","",""
"67792455059110","15424.85","-0.62","EURd","SWAP","PROCESSED","2024-07-21 21:05:33","","Natural Gas","Natural Gas","",""
"67792455058998","15425.47","-0.62","EURd","SWAP","PROCESSED","2024-07-21 21:05:33","","Natural Gas","Natural Gas","",""
"67792454010201","15426.09","-0.62","EURd","SWAP","PROCESSED","2024-07-21 21:05:32","","Natural Gas","Natural Gas","",""
"67701853839752","15426.71","-0.62","EURd","SWAP","PROCESSED","2024-07-20 21:05:29","","Natural Gas","Natural Gas","",""
"67701853839639","15427.33","-0.62","EURd","SWAP","PROCESSED","2024-07-20 21:05:29","","Natural Gas","Natural Gas","",""
"67701852790787","15427.95","-0.62","EURd","SWAP","PROCESSED","2024-07-20 21:05:28","","Natural Gas","Natural Gas","",""
"67611246459192","15428.57","-0.62","EURd","SWAP","PROCESSED","2024-07-19 21:05:19","","Natural Gas","Natural Gas","",""
"67611246459077","15429.19","-0.62","EURd","SWAP","PROCESSED","2024-07-19 21:05:19","","Natural Gas","Natural Gas","",""
"67611246458802","15429.81","-0.62","EURd","SWAP","PROCESSED","2024-07-19 21:05:19","","Natural Gas","Natural Gas","",""
"67520652557367","15430.43","-0.62","EURd","SWAP","PROCESSED","2024-07-18 21:05:22","","Natural Gas","Natural Gas","",""
"67520652557234","15431.05","-0.62","EURd","SWAP","PROCESSED","2024-07-18 21:05:22","","Natural Gas","Natural Gas","",""
"67520652557079","15431.67","-0.62","EURd","SWAP","PROCESSED","2024-07-18 21:05:22","","Natural Gas","Natural Gas","",""
"67430068184333","15432.29","-0.37","EURd","SWAP","PROCESSED","2024-07-17 21:05:34","","Natural Gas","Natural Gas","",""
"67430068184191","15432.66","-0.37","EURd","SWAP","PROCESSED","2024-07-17 21:05:34","","Natural Gas","Natural Gas","",""
"67430068183966","15433.03","-0.37","EURd","SWAP","PROCESSED","2024-07-17 21:05:34","","Natural Gas","Natural Gas","",""
"67355236568769","15433.4","52.47","EURd","TRADE","PROCESSED","2024-07-17 01:16:09","0015421d-0055-311e-0000-4dd100016131_0015421d-0055-311e-0000-0000811869ea","ETH/USD","Ethereum / USD","",""
"67339465934667","15380.93","-0.38","EURd","SWAP","PROCESSED","2024-07-16 21:05:29","","Natural Gas","Natural Gas","",""
"67339465934397","15381.31","-0.38","EURd","SWAP","PROCESSED","2024-07-16 21:05:29","","Natural Gas","Natural Gas","",""
"67339465934159","15381.69","-0.38","EURd","SWAP","PROCESSED","2024-07-16 21:05:29","","Natural Gas","Natural Gas","",""
"67310812642478","15382.07","-0.37","EURd","TRADE","PROCESSED","2024-07-16 13:30:03","004433cd-0055-311e-0000-4dd00000e43a_004433cd-0055-311e-0000-00008040008b","QCOM","QUALCOMM Inc (Extended Hours)","",""
"67310812642476","15382.44","13.6","EURd","TRADE","PROCESSED","2024-07-16 13:30:03","004433cd-0055-311e-0000-4dd00000e439_004433cd-0055-311e-0000-000080400092","QCOM","QUALCOMM Inc (Extended Hours)","",""
"67310812642475","15368.84","39.8","EURd","TRADE","PROCESSED","2024-07-16 13:30:03","004433cd-0055-311e-0000-4dd00000e438_004433cd-0055-311e-0000-0000804000d6","QCOM","QUALCOMM Inc (Extended Hours)","",""
"67248862670724","15329.04","-0.21","EURd","SWAP","PROCESSED","2024-07-15 21:05:23","","Natural Gas","Natural Gas","",""
"67248862670417","15329.25","-0.21","EURd","SWAP","PROCESSED","2024-07-15 21:05:23","","Natural Gas","Natural Gas","",""
"67248862670222","15329.46","-0.21","EURd","SWAP","PROCESSED","2024-07-15 21:05:23","","Natural Gas","Natural Gas","",""
"67158294105132","15329.67","-0.17","EURd","SWAP","PROCESSED","2024-07-14 21:05:50","","Natural Gas","Natural Gas","",""
"67158294104819","15329.84","-0.17","EURd","SWAP","PROCESSED","2024-07-14 21:05:50","","Natural Gas","Natural Gas","",""
"67158294104609","15330.01","-0.17","EURd","SWAP","PROCESSED","2024-07-14 21:05:50","","Natural Gas","Natural Gas","",""
"67152429410338","15330.18","20.79","EURd","TRADE","PROCESSED","2024-07-14 19:32:37","0015421d-0055-311e-0000-4dce000f5927_0015421d-0055-311e-0000-000081181648","ETH/USD","Ethereum / USD","",""
"67067667791390","15309.39","-0.17","EURd","SWAP","PROCESSED","2024-07-13 21:05:22","","Natural Gas","Natural Gas","",""
"67067667791091","15309.56","-0.17","EURd","SWAP","PROCESSED","2024-07-13 21:05:22","","Natural Gas","Natural Gas","",""
"67067667790871","15309.73","-0.17","EURd","SWAP","PROCESSED","2024-07-13 21:05:22","","Natural Gas","Natural Gas","",""
"66977055020985","15309.9","-0.17","EURd","SWAP","PROCESSED","2024-07-12 21:05:07","","Natural Gas","Natural Gas","",""
"66977055020633","15310.07","-0.17","EURd","SWAP","PROCESSED","2024-07-12 21:05:07","","Natural Gas","Natural Gas","",""
"66977055020383","15310.24","-0.17","EURd","SWAP","PROCESSED","2024-07-12 21:05:07","","Natural Gas","Natural Gas","",""
"66950191619044","15310.41","10.19","EURd","TRADE","PROCESSED","2024-07-12 13:58:08","00001344-0055-311e-0000-4dcc00036e63_00001344-0055-311e-0000-000080412d21","AMD","Advanced Micro Devices Inc (Extended Hours)","",""
"66950191619040","15300.22","14.78","EURd","TRADE","PROCESSED","2024-07-12 13:58:08","00001344-0055-311e-0000-4dcc00036e62_00001344-0055-311e-0000-000080412d26","AMD","Advanced Micro Devices Inc (Extended Hours)","",""
"66949092697553","15285.44","21.15","EURd","TRADE","PROCESSED","2024-07-12 13:40:40","00513301-0055-311e-0000-4dcc00081e79_00513301-0055-311e-0000-000080b92ade","TSLA","Tesla Inc (Extended Hours)","",""
"66948515973417","15264.29","-15.33","EURd","TRADE","PROCESSED","2024-07-12 13:31:30","00001344-0055-311e-0000-4dcc00011c53_00001344-0055-311e-0000-000080412764","AMD","Advanced Micro Devices Inc (Extended Hours)","",""
"66948515973415","15279.62","29","EURd","TRADE","PROCESSED","2024-07-12 13:31:30","00001344-0055-311e-0000-4dcc00011c52_00001344-0055-311e-0000-000080412ba9","AMD","Advanced Micro Devices Inc (Extended Hours)","",""
"66948225515373","15250.62","4.72","EURd","TRADE","PROCESSED","2024-07-12 13:26:53","0015421d-0055-311e-0000-4dcc000c7a05_0015421d-0055-311e-0000-000081182070","ETH/USD","Ethereum / USD","",""
"66886458093234","15245.9","-0.35","EURd","SWAP","PROCESSED","2024-07-11 21:05:07","","Natural Gas","Natural Gas","",""
"66886458092604","15246.25","-0.35","EURd","SWAP","PROCESSED","2024-07-11 21:05:07","","Natural Gas","Natural Gas","",""
"66886458092424","15246.6","-0.35","EURd","SWAP","PROCESSED","2024-07-11 21:05:07","","Natural Gas","Natural Gas","",""
"66795928226600","15246.95","-0.33","EURd","SWAP","PROCESSED","2024-07-10 21:06:11","","Natural Gas","Natural Gas","",""
"66795928225862","15247.28","-0.33","EURd","SWAP","PROCESSED","2024-07-10 21:06:11","","Natural Gas","Natural Gas","",""
"66795928225597","15247.61","-0.33","EURd","SWAP","PROCESSED","2024-07-10 21:06:11","","Natural Gas","Natural Gas","",""
"66787513429913","15247.94","7.48","EURd","TRADE","PROCESSED","2024-07-10 18:52:26","00081081-0055-311e-0000-4dca000c430e_00081081-0055-311e-0000-000080410327","BABA","Alibaba Group Holding Limited (Extended Hours)","",""
"66787513429912","15240.46","7.48","EURd","TRADE","PROCESSED","2024-07-10 18:52:26","00081081-0055-311e-0000-4dca000c430d_00081081-0055-311e-0000-000080410325","BABA","Alibaba Group Holding Limited (Extended Hours)","",""
"66787508187018","15232.98","46.65","EURd","TRADE","PROCESSED","2024-07-10 18:52:21","00001344-0055-311e-0000-4dca000c4276_00001344-0055-311e-0000-00008041200e","AMD","Advanced Micro Devices Inc (Extended Hours)","",""
"66749207825899","15186.33","18.31","EURd","TRADE","PROCESSED","2024-07-10 08:43:35","000144cd-0055-311e-0000-4dca0004cc22_000144cd-0055-311e-0000-00008079018e","TSM","Taiwan Semiconductor Manufacturing Co Ltd - ADR (Extended Hours)","",""
"66749205728732","15168.02","25.77","EURd","TRADE","PROCESSED","2024-07-10 08:43:33","0015421d-0055-311e-0000-4dca00086fff_0015421d-0055-311e-0000-00008115b251","ETH/USD","Ethereum / USD","",""
"66705328171788","15142.25","-0.31","EURd","SWAP","PROCESSED","2024-07-09 21:06:08","","Natural Gas","Natural Gas","",""
"66705328171539","15142.56","-0.31","EURd","SWAP","PROCESSED","2024-07-09 21:06:08","","Natural Gas","Natural Gas","",""
"66685319191059","15142.87","6.98","EURd","TRADE","PROCESSED","2024-07-09 15:48:06","00000182-0055-311e-0000-4dc90009fd21_00000182-0055-311e-0000-000080740942","META","Meta Platforms Inc (Extended Hours)","",""
"66685318142473","15135.89","9.8","EURd","TRADE","PROCESSED","2024-07-09 15:48:05","00396101-0055-311e-0000-4dc900082b8d_00396101-0055-311e-0000-0000804837f6","NVDA","NVIDIA Corp (Extended Hours)","",""
"66685314996726","15126.09","-0.18","EURd","TRADE","PROCESSED","2024-07-09 15:48:02","00081081-0055-311e-0000-4dc900082b25_00081081-0055-311e-0000-0000803e0cbb","BABA","Alibaba Group Holding Limited (Extended Hours)","",""
"66685314996725","15126.27","10.91","EURd","TRADE","PROCESSED","2024-07-09 15:48:02","00081081-0055-311e-0000-4dc900082b24_00081081-0055-311e-0000-00008041021b","BABA","Alibaba Group Holding Limited (Extended Hours)","",""
"66685310802384","15115.36","30.66","EURd","TRADE","PROCESSED","2024-07-09 15:47:58","00513301-0055-311e-0000-4dc90009fc59_00513301-0055-311e-0000-000080b86b7c","TSLA","Tesla Inc (Extended Hours)","",""
"66685310802383","15084.7","56.74","EURd","TRADE","PROCESSED","2024-07-09 15:47:58","00513301-0055-311e-0000-4dc90009fc58_00513301-0055-311e-0000-000080b88e6d","TSLA","Tesla Inc (Extended Hours)","",""
"66685310802382","15027.96","62.71","EURd","TRADE","PROCESSED","2024-07-09 15:47:58","00513301-0055-311e-0000-4dc90009fc57_00513301-0055-311e-0000-000080b89854","TSLA","Tesla Inc (Extended Hours)","",""
"66653120525083","14965.25","9.1","EURd","TRADE","PROCESSED","2024-07-09 07:16:19","000940dd-0055-311e-0000-4dc900038020_000940dd-0055-311e-0000-000082054f79","BTC/USD","Bitcoin / USD","",""
"66653113185023","14956.15","-104.55","EURd","TRADE","PROCESSED","2024-07-09 07:16:12","0015421d-0055-311e-0000-4dc900044ab2_0015421d-0055-311e-0000-000081119f27","ETH/USD","Ethereum / USD","",""
"66653113185022","15060.7","50.4","EURd","TRADE","PROCESSED","2024-07-09 07:16:12","0015421d-0055-311e-0000-4dc900044ab1_0015421d-0055-311e-0000-000081158cb2","ETH/USD","Ethereum / USD","",""
"66653113185021","15010.3","76.2","EURd","TRADE","PROCESSED","2024-07-09 07:16:12","0015421d-0055-311e-0000-4dc900044ab0_0015421d-0055-311e-0000-00008115a571","ETH/USD","Ethereum / USD","",""
"66653113185020","14934.1","182.24","EURd","TRADE","PROCESSED","2024-07-09 07:16:12","0015421d-0055-311e-0000-4dc900044aaf_0015421d-0055-311e-0000-000081155e76","ETH/USD","Ethereum / USD","",""
"66587419967895","14751.86","18.82","EURd","TRADE","PROCESSED","2024-07-08 13:52:02","00396101-0055-311e-0000-4dc80003cd16_00396101-0055-311e-0000-00008044d0b8","NVDA","NVIDIA Corp (Extended Hours)","",""
"66587419967893","14733.04","50.37","EURd","TRADE","PROCESSED","2024-07-08 13:52:02","00396101-0055-311e-0000-4dc80003cd15_00396101-0055-311e-0000-000080483284","NVDA","NVIDIA Corp (Extended Hours)","",""
"66585663585398","14682.67","-75.15","EURd","TRADE","PROCESSED","2024-07-08 13:24:07","00001344-0055-311e-0000-4dc80001d41d_00001344-0055-311e-0000-000080350160","AMD","Advanced Micro Devices Inc (Extended Hours)","",""
"66585662536820","14757.82","93.69","EURd","TRADE","PROCESSED","2024-07-08 13:24:06","00001344-0055-311e-0000-4dc80001d41c_00001344-0055-311e-0000-000080410ebe","AMD","Advanced Micro Devices Inc (Extended Hours)","",""
"66567703495992","14664.13","27.72","EURd","TRADE","PROCESSED","2024-07-08 08:38:39","000144cd-0055-311e-0000-4dc80005b82c_000144cd-0055-311e-0000-000080790074","TSM","Taiwan Semiconductor Manufacturing Co Ltd - ADR (Extended Hours)","",""
"66567674135769","14636.41","133.43","EURd","TRADE","PROCESSED","2024-07-08 08:38:11","00000182-0055-311e-0000-4dc800051d9b_00000182-0055-311e-0000-0000807403ee","META","Meta Platforms Inc (Extended Hours)","",""
"66294123779708","14502.98","28.08","EURd","TRADE","PROCESSED","2024-07-05 08:10:13","00513301-0055-311e-0000-4dc50005854c_00513301-0055-311e-0000-0000808fec28","TSLA","Tesla Inc (Extended Hours)","",""
"66294123779705","14474.9","39.25","EURd","TRADE","PROCESSED","2024-07-05 08:10:13","00513301-0055-311e-0000-4dc50005854b_00513301-0055-311e-0000-0000808fe37f","TSLA","Tesla Inc (Extended Hours)","",""
"66294123779701","14435.65","141.96","EURd","TRADE","PROCESSED","2024-07-05 08:10:13","00513301-0055-311e-0000-4dc50005854a_00513301-0055-311e-0000-000080913bd6","TSLA","Tesla Inc (Extended Hours)","",""
"66294123779700","14293.69","-29","EURd","TRADE","PROCESSED","2024-07-05 08:10:13","00513301-0055-311e-0000-4dc500058549_00513301-0055-311e-0000-0000808fc99f","TSLA","Tesla Inc (Extended Hours)","",""
"66294123779696","14322.69","119.89","EURd","TRADE","PROCESSED","2024-07-05 08:10:13","00513301-0055-311e-0000-4dc500058548_00513301-0055-311e-0000-000080919420","TSLA","Tesla Inc (Extended Hours)","",""
"66294123779695","14202.8","165.24","EURd","TRADE","PROCESSED","2024-07-05 08:10:13","00513301-0055-311e-0000-4dc500058547_00513301-0055-311e-0000-00008091db45","TSLA","Tesla Inc (Extended Hours)","",""
"65041088037888","14037.56","53.14","EURd","TRADE","PROCESSED","2024-06-21 12:13:45","00001344-0055-311e-0000-4db70001daff_00001344-0055-311e-0000-0000803e7066","AMD","Advanced Micro Devices Inc (Extended Hours)","",""
"64802801282667","13984.42","-0.37","EURd","SWAP","PROCESSED","2024-06-18 21:06:17","","AMD","Advanced Micro Devices Inc (Extended Hours)","",""
"64802801281619","13984.79","-0.19","EURd","SWAP","PROCESSED","2024-06-18 21:06:17","","AMD","Advanced Micro Devices Inc (Extended Hours)","",""
"64802784469268","13984.98","-0.22","EURd","SWAP","PROCESSED","2024-06-18 21:06:01","","TSLA","Tesla Inc (Extended Hours)","",""
"64802784468936","13985.2","-0.22","EURd","SWAP","PROCESSED","2024-06-18 21:06:01","","TSLA","Tesla Inc (Extended Hours)","",""
"64802784468902","13985.42","-0.45","EURd","SWAP","PROCESSED","2024-06-18 21:06:01","","TSLA","Tesla Inc (Extended Hours)","",""
"64802784468856","13985.87","-0.22","EURd","SWAP","PROCESSED","2024-06-18 21:06:01","","TSLA","Tesla Inc (Extended Hours)","",""
"64802784468823","13986.09","-0.45","EURd","SWAP","PROCESSED","2024-06-18 21:06:01","","TSLA","Tesla Inc (Extended Hours)","",""
"64802784468717","13986.54","-0.45","EURd","SWAP","PROCESSED","2024-06-18 21:06:01","","TSLA","Tesla Inc (Extended Hours)","",""
"64802759248141","13986.99","-0.19","EURd","SWAP","PROCESSED","2024-06-18 21:05:37","","BABA","Alibaba Group Holding Limited (Extended Hours)","",""
"64712195903766","13987.18","-0.2","EURd","SWAP","PROCESSED","2024-06-17 21:06:09","","AMD","Advanced Micro Devices Inc (Extended Hours)","",""
"64712185394664","13987.38","-0.23","EURd","SWAP","PROCESSED","2024-06-17 21:05:59","","TSLA","Tesla Inc (Extended Hours)","",""
"64712185394373","13987.61","-0.23","EURd","SWAP","PROCESSED","2024-06-17 21:05:59","","TSLA","Tesla Inc (Extended Hours)","",""
"64712185394286","13987.84","-0.46","EURd","SWAP","PROCESSED","2024-06-17 21:05:59","","TSLA","Tesla Inc (Extended Hours)","",""
"64712185394227","13988.3","-0.23","EURd","SWAP","PROCESSED","2024-06-17 21:05:59","","TSLA","Tesla Inc (Extended Hours)","",""
"64712185394194","13988.53","-0.46","EURd","SWAP","PROCESSED","2024-06-17 21:05:59","","TSLA","Tesla Inc (Extended Hours)","",""
"64712185394147","13988.99","-0.46","EURd","SWAP","PROCESSED","2024-06-17 21:05:59","","TSLA","Tesla Inc (Extended Hours)","",""
"64712161348911","13989.45","-0.19","EURd","SWAP","PROCESSED","2024-06-17 21:05:36","","BABA","Alibaba Group Holding Limited (Extended Hours)","",""
"64621598996302","13989.64","-0.2","EURd","SWAP","PROCESSED","2024-06-16 21:06:09","","AMD","Advanced Micro Devices Inc (Extended Hours)","",""
"64621584281198","13989.84","-0.21","EURd","SWAP","PROCESSED","2024-06-16 21:05:55","","TSLA","Tesla Inc (Extended Hours)","",""
"64621584280914","13990.05","-0.21","EURd","SWAP","PROCESSED","2024-06-16 21:05:55","","TSLA","Tesla Inc (Extended Hours)","",""
"64621584280849","13990.26","-0.44","EURd","SWAP","PROCESSED","2024-06-16 21:05:55","","TSLA","Tesla Inc (Extended Hours)","",""
"64621584280783","13990.7","-0.21","EURd","SWAP","PROCESSED","2024-06-16 21:05:55","","TSLA","Tesla Inc (Extended Hours)","",""
"64621584280716","13990.91","-0.44","EURd","SWAP","PROCESSED","2024-06-16 21:05:55","","TSLA","Tesla Inc (Extended Hours)","",""
"64621584280697","13991.35","-0.44","EURd","SWAP","PROCESSED","2024-06-16 21:05:55","","TSLA","Tesla Inc (Extended Hours)","",""
"64621561158242","13991.79","-0.18","EURd","SWAP","PROCESSED","2024-06-16 21:05:33","","BABA","Alibaba Group Holding Limited (Extended Hours)","",""
"64531002004509","13991.97","-0.2","EURd","SWAP","PROCESSED","2024-06-15 21:06:09","","AMD","Advanced Micro Devices Inc (Extended Hours)","",""
"64530987292854","13992.17","-0.21","EURd","SWAP","PROCESSED","2024-06-15 21:05:55","","TSLA","Tesla Inc (Extended Hours)","",""
"64530987292563","13992.38","-0.21","EURd","SWAP","PROCESSED","2024-06-15 21:05:55","","TSLA","Tesla Inc (Extended Hours)","",""
"64530987292494","13992.59","-0.44","EURd","SWAP","PROCESSED","2024-06-15 21:05:55","","TSLA","Tesla Inc (Extended Hours)","",""
"64530987292415","13993.03","-0.21","EURd","SWAP","PROCESSED","2024-06-15 21:05:55","","TSLA","Tesla Inc (Extended Hours)","",""
"64530987292368","13993.24","-0.44","EURd","SWAP","PROCESSED","2024-06-15 21:05:55","","TSLA","Tesla Inc (Extended Hours)","",""
"64530987292321","13993.68","-0.44","EURd","SWAP","PROCESSED","2024-06-15 21:05:55","","TSLA","Tesla Inc (Extended Hours)","",""
"64530970480792","13994.12","-0.18","EURd","SWAP","PROCESSED","2024-06-15 21:05:39","","BABA","Alibaba Group Holding Limited (Extended Hours)","",""
"64440422762150","13994.3","-0.2","EURd","SWAP","PROCESSED","2024-06-14 21:06:26","","AMD","Advanced Micro Devices Inc (Extended Hours)","",""
"64440388211415","13994.5","-0.18","EURd","SWAP","PROCESSED","2024-06-14 21:05:53","","BABA","Alibaba Group Holding Limited (Extended Hours)","",""
"64440368243545","13994.68","-0.21","EURd","SWAP","PROCESSED","2024-06-14 21:05:34","","TSLA","Tesla Inc (Extended Hours)","",""
"64440368243189","13994.89","-0.21","EURd","SWAP","PROCESSED","2024-06-14 21:05:34","","TSLA","Tesla Inc (Extended Hours)","",""
"64440368243139","13995.1","-0.44","EURd","SWAP","PROCESSED","2024-06-14 21:05:34","","TSLA","Tesla Inc (Extended Hours)","",""
"64440368243092","13995.54","-0.21","EURd","SWAP","PROCESSED","2024-06-14 21:05:34","","TSLA","Tesla Inc (Extended Hours)","",""
"64440368243036","13995.75","-0.44","EURd","SWAP","PROCESSED","2024-06-14 21:05:34","","TSLA","Tesla Inc (Extended Hours)","",""
"64440368242961","13996.19","-0.44","EURd","SWAP","PROCESSED","2024-06-14 21:05:34","","TSLA","Tesla Inc (Extended Hours)","",""
"64392110727342","13996.63","-4.25","EURd","TRADE","PROCESSED","2024-06-14 08:18:32","00513301-0055-311e-0000-4db0000514ff_00513301-0055-311e-0000-000080b13080","TSLA","Tesla Inc (Extended Hours)","",""
"64392088707177","14000.88","27.29","EURd","TRADE","PROCESSED","2024-06-14 08:18:11","00513301-0055-311e-0000-4db000051395_00513301-0055-311e-0000-000080b24cac","TSLA","Tesla Inc (Extended Hours)","",""
"64392081367123","13973.59","89.39","EURd","TRADE","PROCESSED","2024-06-14 08:18:04","00396101-0055-311e-0000-4db00002b333_00396101-0055-311e-0000-000080446904","NVDA","NVIDIA Corp (Extended Hours)","",""
"64349835309880","13884.2","-0.2","EURd","SWAP","PROCESSED","2024-06-13 21:06:35","","AMD","Advanced Micro Devices Inc (Extended Hours)","",""
"64349814294442","13884.4","-0.09","EURd","SWAP","PROCESSED","2024-06-13 21:06:15","","TSLA","Tesla Inc (Extended Hours)","",""
"64349814292901","13884.49","-0.22","EURd","SWAP","PROCESSED","2024-06-13 21:06:15","","TSLA","Tesla Inc (Extended Hours)","",""
"64349812192617","13884.71","-0.22","EURd","SWAP","PROCESSED","2024-06-13 21:06:13","","TSLA","Tesla Inc (Extended Hours)","",""
"64349812192319","13884.93","-0.22","EURd","SWAP","PROCESSED","2024-06-13 21:06:13","","TSLA","Tesla Inc (Extended Hours)","",""
"64349812192253","13885.15","-0.45","EURd","SWAP","PROCESSED","2024-06-13 21:06:13","","TSLA","Tesla Inc (Extended Hours)","",""
"64349812192197","13885.6","-0.22","EURd","SWAP","PROCESSED","2024-06-13 21:06:13","","TSLA","Tesla Inc (Extended Hours)","",""
"64349812192131","13885.82","-0.45","EURd","SWAP","PROCESSED","2024-06-13 21:06:13","","TSLA","Tesla Inc (Extended Hours)","",""
"64349812192072","13886.27","-0.45","EURd","SWAP","PROCESSED","2024-06-13 21:06:13","","TSLA","Tesla Inc (Extended Hours)","",""
"64349769236440","13886.72","-0.32","EURd","SWAP","PROCESSED","2024-06-13 21:05:31","","NVDA","NVIDIA Corp (Extended Hours)","",""
"64259229968523","13887.04","-0.19","EURd","SWAP","PROCESSED","2024-06-12 21:06:27","","AMD","Advanced Micro Devices Inc (Extended Hours)","",""
"64259224714614","13887.23","-0.08","EURd","SWAP","PROCESSED","2024-06-12 21:06:22","","TSLA","Tesla Inc (Extended Hours)","",""
"64259223663923","13887.31","-0.21","EURd","SWAP","PROCESSED","2024-06-12 21:06:21","","TSLA","Tesla Inc (Extended Hours)","",""
"64259222612110","13887.52","-0.21","EURd","SWAP","PROCESSED","2024-06-12 21:06:20","","TSLA","Tesla Inc (Extended Hours)","",""
"64259222611834","13887.73","-0.21","EURd","SWAP","PROCESSED","2024-06-12 21:06:20","","TSLA","Tesla Inc (Extended Hours)","",""
"64259222611752","13887.94","-0.43","EURd","SWAP","PROCESSED","2024-06-12 21:06:20","","TSLA","Tesla Inc (Extended Hours)","",""
"64259222611701","13888.37","-0.21","EURd","SWAP","PROCESSED","2024-06-12 21:06:20","","TSLA","Tesla Inc (Extended Hours)","",""
"64259222611639","13888.58","-0.43","EURd","SWAP","PROCESSED","2024-06-12 21:06:20","","TSLA","Tesla Inc (Extended Hours)","",""
"64259222611592","13889.01","-0.43","EURd","SWAP","PROCESSED","2024-06-12 21:06:20","","TSLA","Tesla Inc (Extended Hours)","",""
"64259166001504","13889.44","-0.31","EURd","SWAP","PROCESSED","2024-06-12 21:05:26","","NVDA","NVIDIA Corp (Extended Hours)","",""
"64168627719031","13889.75","-0.2","EURd","SWAP","PROCESSED","2024-06-11 21:06:22","","AMD","Advanced Micro Devices Inc (Extended Hours)","",""
"64168616158338","13889.95","-0.2","EURd","SWAP","PROCESSED","2024-06-11 21:06:11","","TSLA","Tesla Inc (Extended Hours)","",""
"64168615106581","13890.15","-0.2","EURd","SWAP","PROCESSED","2024-06-11 21:06:10","","TSLA","Tesla Inc (Extended Hours)","",""
"64168614057801","13890.35","-0.2","EURd","SWAP","PROCESSED","2024-06-11 21:06:09","","TSLA","Tesla Inc (Extended Hours)","",""
"64168614057764","13890.55","-0.42","EURd","SWAP","PROCESSED","2024-06-11 21:06:09","","TSLA","Tesla Inc (Extended Hours)","",""
"64168614057712","13890.97","-0.2","EURd","SWAP","PROCESSED","2024-06-11 21:06:09","","TSLA","Tesla Inc (Extended Hours)","",""
"64168614057654","13891.17","-0.42","EURd","SWAP","PROCESSED","2024-06-11 21:06:09","","TSLA","Tesla Inc (Extended Hours)","",""
"64168614057558","13891.59","-0.42","EURd","SWAP","PROCESSED","2024-06-11 21:06:09","","TSLA","Tesla Inc (Extended Hours)","",""
"64078038169119","13892.01","-0.2","EURd","SWAP","PROCESSED","2024-06-10 21:06:29","","AMD","Advanced Micro Devices Inc (Extended Hours)","",""
"64078023454934","13892.21","-0.21","EURd","SWAP","PROCESSED","2024-06-10 21:06:15","","TSLA","Tesla Inc (Extended Hours)","",""
"64078022402812","13892.42","-0.21","EURd","SWAP","PROCESSED","2024-06-10 21:06:14","","TSLA","Tesla Inc (Extended Hours)","",""
"64078021353917","13892.63","-0.21","EURd","SWAP","PROCESSED","2024-06-10 21:06:13","","TSLA","Tesla Inc (Extended Hours)","",""
"64078021353856","13892.84","-0.43","EURd","SWAP","PROCESSED","2024-06-10 21:06:13","","TSLA","Tesla Inc (Extended Hours)","",""
"64078021353803","13893.27","-0.21","EURd","SWAP","PROCESSED","2024-06-10 21:06:13","","TSLA","Tesla Inc (Extended Hours)","",""
"64078021353761","13893.48","-0.43","EURd","SWAP","PROCESSED","2024-06-10 21:06:13","","TSLA","Tesla Inc (Extended Hours)","",""
"64078021353689","13893.91","-0.43","EURd","SWAP","PROCESSED","2024-06-10 21:06:13","","TSLA","Tesla Inc (Extended Hours)","",""
"63987439013052","13894.34","-0.2","EURd","SWAP","PROCESSED","2024-06-09 21:06:27","","AMD","Advanced Micro Devices Inc (Extended Hours)","",""
"63987424427669","13894.54","-0.21","EURd","SWAP","PROCESSED","2024-06-09 21:06:13","","TSLA","Tesla Inc (Extended Hours)","",""
"63987423375667","13894.75","-0.21","EURd","SWAP","PROCESSED","2024-06-09 21:06:12","","TSLA","Tesla Inc (Extended Hours)","",""
"63987423375350","13894.96","-0.21","EURd","SWAP","PROCESSED","2024-06-09 21:06:12","","TSLA","Tesla Inc (Extended Hours)","",""
"63987423375299","13895.17","-0.44","EURd","SWAP","PROCESSED","2024-06-09 21:06:12","","TSLA","Tesla Inc (Extended Hours)","",""
"63987423375242","13895.61","-0.21","EURd","SWAP","PROCESSED","2024-06-09 21:06:12","","TSLA","Tesla Inc (Extended Hours)","",""
"63987423375181","13895.82","-0.44","EURd","SWAP","PROCESSED","2024-06-09 21:06:12","","TSLA","Tesla Inc (Extended Hours)","",""
"63987423375122","13896.26","-0.44","EURd","SWAP","PROCESSED","2024-06-09 21:06:12","","TSLA","Tesla Inc (Extended Hours)","",""
"63896837831176","13896.7","-0.2","EURd","SWAP","PROCESSED","2024-06-08 21:06:23","","AMD","Advanced Micro Devices Inc (Extended Hours)","",""
"63896824294922","13896.9","-0.21","EURd","SWAP","PROCESSED","2024-06-08 21:06:10","","TSLA","Tesla Inc (Extended Hours)","",""
"63896822194504","13897.11","-0.21","EURd","SWAP","PROCESSED","2024-06-08 21:06:08","","TSLA","Tesla Inc (Extended Hours)","",""
"63896822194186","13897.32","-0.21","EURd","SWAP","PROCESSED","2024-06-08 21:06:08","","TSLA","Tesla Inc (Extended Hours)","",""
"63896822194120","13897.53","-0.44","EURd","SWAP","PROCESSED","2024-06-08 21:06:08","","TSLA","Tesla Inc (Extended Hours)","",""
"63896822194049","13897.97","-0.21","EURd","SWAP","PROCESSED","2024-06-08 21:06:08","","TSLA","Tesla Inc (Extended Hours)","",""
"63896822193950","13898.18","-0.44","EURd","SWAP","PROCESSED","2024-06-08 21:06:08","","TSLA","Tesla Inc (Extended Hours)","",""
"63896822193891","13898.62","-0.44","EURd","SWAP","PROCESSED","2024-06-08 21:06:08","","TSLA","Tesla Inc (Extended Hours)","",""
"63806243074937","13899.06","-0.2","EURd","SWAP","PROCESSED","2024-06-07 21:06:25","","AMD","Advanced Micro Devices Inc (Extended Hours)","",""
"63806237822528","13899.26","-0.21","EURd","SWAP","PROCESSED","2024-06-07 21:06:20","","TSLA","Tesla Inc (Extended Hours)","",""
"63806236770825","13899.47","-0.21","EURd","SWAP","PROCESSED","2024-06-07 21:06:19","","TSLA","Tesla Inc (Extended Hours)","",""
"63806236770559","13899.68","-0.21","EURd","SWAP","PROCESSED","2024-06-07 21:06:19","","TSLA","Tesla Inc (Extended Hours)","",""
"63806236770489","13899.89","-0.44","EURd","SWAP","PROCESSED","2024-06-07 21:06:19","","TSLA","Tesla Inc (Extended Hours)","",""
"63806236770421","13900.33","-0.21","EURd","SWAP","PROCESSED","2024-06-07 21:06:19","","TSLA","Tesla Inc (Extended Hours)","",""
"63806236770361","13900.54","-0.44","EURd","SWAP","PROCESSED","2024-06-07 21:06:19","","TSLA","Tesla Inc (Extended Hours)","",""
"63806236770290","13900.98","-0.44","EURd","SWAP","PROCESSED","2024-06-07 21:06:19","","TSLA","Tesla Inc (Extended Hours)","",""
"63715651270099","13901.42","-0.2","EURd","SWAP","PROCESSED","2024-06-06 21:06:30","","AMD","Advanced Micro Devices Inc (Extended Hours)","",""
"63715637611210","13901.62","-0.21","EURd","SWAP","PROCESSED","2024-06-06 21:06:17","","TSLA","Tesla Inc (Extended Hours)","",""
"63715635510707","13901.83","-0.21","EURd","SWAP","PROCESSED","2024-06-06 21:06:15","","TSLA","Tesla Inc (Extended Hours)","",""
"63715635510477","13902.04","-0.21","EURd","SWAP","PROCESSED","2024-06-06 21:06:15","","TSLA","Tesla Inc (Extended Hours)","",""
"63715635510410","13902.25","-0.43","EURd","SWAP","PROCESSED","2024-06-06 21:06:15","","TSLA","Tesla Inc (Extended Hours)","",""
"63715635510360","13902.68","-0.21","EURd","SWAP","PROCESSED","2024-06-06 21:06:15","","TSLA","Tesla Inc (Extended Hours)","",""
"63715635510286","13902.89","-0.43","EURd","SWAP","PROCESSED","2024-06-06 21:06:15","","TSLA","Tesla Inc (Extended Hours)","",""
"63715635510175","13903.32","-0.43","EURd","SWAP","PROCESSED","2024-06-06 21:06:15","","TSLA","Tesla Inc (Extended Hours)","",""
"63625055388920","13903.75","-0.2","EURd","SWAP","PROCESSED","2024-06-05 21:06:31","","AMD","Advanced Micro Devices Inc (Extended Hours)","",""
"63625039624797","13903.95","-0.21","EURd","SWAP","PROCESSED","2024-06-05 21:06:16","","TSLA","Tesla Inc (Extended Hours)","",""
"63625038572778","13904.16","-0.21","EURd","SWAP","PROCESSED","2024-06-05 21:06:15","","TSLA","Tesla Inc (Extended Hours)","",""
"63625038572541","13904.37","-0.21","EURd","SWAP","PROCESSED","2024-06-05 21:06:15","","TSLA","Tesla Inc (Extended Hours)","",""
"63625038572491","13904.58","-0.42","EURd","SWAP","PROCESSED","2024-06-05 21:06:15","","TSLA","Tesla Inc (Extended Hours)","",""
"63625038572420","13905","-0.21","EURd","SWAP","PROCESSED","2024-06-05 21:06:15","","TSLA","Tesla Inc (Extended Hours)","",""
"63625038572373","13905.21","-0.42","EURd","SWAP","PROCESSED","2024-06-05 21:06:15","","TSLA","Tesla Inc (Extended Hours)","",""
"63625038572260","13905.63","-0.42","EURd","SWAP","PROCESSED","2024-06-05 21:06:15","","TSLA","Tesla Inc (Extended Hours)","",""
"63620892543735","13906.05","8.64","EURd","TRADE","PROCESSED","2024-06-05 20:00:21","000144cd-0055-311e-0000-4da7001a4799_000144cd-0055-311e-0000-0000807200d0","TSM","Taiwan Semiconductor Manufacturing Co Ltd - ADR (Extended Hours)","",""
"63620892543732","13897.41","50.26","EURd","TRADE","PROCESSED","2024-06-05 20:00:21","000144cd-0055-311e-0000-4da7001a4798_000144cd-0055-311e-0000-00008072022b","TSM","Taiwan Semiconductor Manufacturing Co Ltd - ADR (Extended Hours)","",""
"63534461588047","13847.15","-0.19","EURd","SWAP","PROCESSED","2024-06-04 21:06:34","","AMD","Advanced Micro Devices Inc (Extended Hours)","",""
"63534434265157","13847.34","-0.21","EURd","SWAP","PROCESSED","2024-06-04 21:06:08","","TSLA","Tesla Inc (Extended Hours)","",""
"63534431114399","13847.55","-0.21","EURd","SWAP","PROCESSED","2024-06-04 21:06:05","","TSLA","Tesla Inc (Extended Hours)","",""
"63534431114098","13847.76","-0.21","EURd","SWAP","PROCESSED","2024-06-04 21:06:05","","TSLA","Tesla Inc (Extended Hours)","",""
"63534431114048","13847.97","-0.42","EURd","SWAP","PROCESSED","2024-06-04 21:06:05","","TSLA","Tesla Inc (Extended Hours)","",""
"63534431114009","13848.39","-0.21","EURd","SWAP","PROCESSED","2024-06-04 21:06:05","","TSLA","Tesla Inc (Extended Hours)","",""
"63534431113929","13848.6","-0.42","EURd","SWAP","PROCESSED","2024-06-04 21:06:05","","TSLA","Tesla Inc (Extended Hours)","",""
"63534431113843","13849.02","-0.42","EURd","SWAP","PROCESSED","2024-06-04 21:06:05","","TSLA","Tesla Inc (Extended Hours)","",""
"63534424808048","13849.44","-0.18","EURd","SWAP","PROCESSED","2024-06-04 21:05:59","","TSM","Taiwan Semiconductor Manufacturing Co Ltd - ADR (Extended Hours)","",""
"63534424807935","13849.62","-0.18","EURd","SWAP","PROCESSED","2024-06-04 21:05:58","","TSM","Taiwan Semiconductor Manufacturing Co Ltd - ADR (Extended Hours)","",""
"63443850992466","13849.8","-0.19","EURd","SWAP","PROCESSED","2024-06-03 21:06:21","","AMD","Advanced Micro Devices Inc (Extended Hours)","",""
"63443836278534","13849.99","-0.21","EURd","SWAP","PROCESSED","2024-06-03 21:06:07","","TSLA","Tesla Inc (Extended Hours)","",""
"63443834177620","13850.2","-0.21","EURd","SWAP","PROCESSED","2024-06-03 21:06:05","","TSLA","Tesla Inc (Extended Hours)","",""
"63443834177369","13850.41","-0.21","EURd","SWAP","PROCESSED","2024-06-03 21:06:05","","TSLA","Tesla Inc (Extended Hours)","",""
"63443834177314","13850.62","-0.42","EURd","SWAP","PROCESSED","2024-06-03 21:06:05","","TSLA","Tesla Inc (Extended Hours)","",""
"63443834177257","13851.04","-0.21","EURd","SWAP","PROCESSED","2024-06-03 21:06:05","","TSLA","Tesla Inc (Extended Hours)","",""
"63443834177141","13851.25","-0.42","EURd","SWAP","PROCESSED","2024-06-03 21:06:05","","TSLA","Tesla Inc (Extended Hours)","",""
"63443834177087","13851.67","-0.42","EURd","SWAP","PROCESSED","2024-06-03 21:06:05","","TSLA","Tesla Inc (Extended Hours)","",""
"63443825771600","13852.09","-0.18","EURd","SWAP","PROCESSED","2024-06-03 21:05:57","","TSM","Taiwan Semiconductor Manufacturing Co Ltd - ADR (Extended Hours)","",""
"63443825771483","13852.27","-0.18","EURd","SWAP","PROCESSED","2024-06-03 21:05:57","","TSM","Taiwan Semiconductor Manufacturing Co Ltd - ADR (Extended Hours)","",""
"63353255064423","13852.45","-0.2","EURd","SWAP","PROCESSED","2024-06-02 21:06:22","","AMD","Advanced Micro Devices Inc (Extended Hours)","",""
"63353240348471","13852.65","-0.21","EURd","SWAP","PROCESSED","2024-06-02 21:06:08","","TSLA","Tesla Inc (Extended Hours)","",""
"63353238247036","13852.86","-0.21","EURd","SWAP","PROCESSED","2024-06-02 21:06:06","","TSLA","Tesla Inc (Extended Hours)","",""
"63353238246747","13853.07","-0.21","EURd","SWAP","PROCESSED","2024-06-02 21:06:06","","TSLA","Tesla Inc (Extended Hours)","",""
"63353238246390","13853.28","-0.43","EURd","SWAP","PROCESSED","2024-06-02 21:06:06","","TSLA","Tesla Inc (Extended Hours)","",""
"63353238246299","13853.71","-0.21","EURd","SWAP","PROCESSED","2024-06-02 21:06:06","","TSLA","Tesla Inc (Extended Hours)","",""
"63353238246186","13853.92","-0.43","EURd","SWAP","PROCESSED","2024-06-02 21:06:06","","TSLA","Tesla Inc (Extended Hours)","",""
"63353237197549","13854.35","-0.43","EURd","SWAP","PROCESSED","2024-06-02 21:06:05","","TSLA","Tesla Inc (Extended Hours)","",""
"63353228787933","13854.78","-0.18","EURd","SWAP","PROCESSED","2024-06-02 21:05:57","","TSM","Taiwan Semiconductor Manufacturing Co Ltd - ADR (Extended Hours)","",""
"63353228787832","13854.96","-0.18","EURd","SWAP","PROCESSED","2024-06-02 21:05:57","","TSM","Taiwan Semiconductor Manufacturing Co Ltd - ADR (Extended Hours)","",""
"63262644412936","13855.14","-0.21","EURd","SWAP","PROCESSED","2024-06-01 21:06:09","","TSLA","Tesla Inc (Extended Hours)","",""
"63262643360602","13855.35","-0.21","EURd","SWAP","PROCESSED","2024-06-01 21:06:08","","TSLA","Tesla Inc (Extended Hours)","",""
"63262643360346","13855.56","-0.21","EURd","SWAP","PROCESSED","2024-06-01 21:06:08","","TSLA","Tesla Inc (Extended Hours)","",""
"63262643360286","13855.77","-0.43","EURd","SWAP","PROCESSED","2024-06-01 21:06:08","","TSLA","Tesla Inc (Extended Hours)","",""
"63262643360234","13856.2","-0.21","EURd","SWAP","PROCESSED","2024-06-01 21:06:08","","TSLA","Tesla Inc (Extended Hours)","",""
"63262643360169","13856.41","-0.43","EURd","SWAP","PROCESSED","2024-06-01 21:06:08","","TSLA","Tesla Inc (Extended Hours)","",""
"63262643360121","13856.84","-0.43","EURd","SWAP","PROCESSED","2024-06-01 21:06:08","","TSLA","Tesla Inc (Extended Hours)","",""
"63262633900904","13857.27","-0.18","EURd","SWAP","PROCESSED","2024-06-01 21:05:59","","TSM","Taiwan Semiconductor Manufacturing Co Ltd - ADR (Extended Hours)","",""
"63262633900781","13857.45","-0.18","EURd","SWAP","PROCESSED","2024-06-01 21:05:59","","TSM","Taiwan Semiconductor Manufacturing Co Ltd - ADR (Extended Hours)","",""
"63262596198110","13857.63","-0.2","EURd","SWAP","PROCESSED","2024-06-01 21:05:23","","AMD","Advanced Micro Devices Inc (Extended Hours)","",""
"63172070551602","13857.83","-0.2","EURd","SWAP","PROCESSED","2024-05-31 21:06:31","","AMD","Advanced Micro Devices Inc (Extended Hours)","",""
"63172058992111","13858.03","-0.18","EURd","SWAP","PROCESSED","2024-05-31 21:06:20","","TSM","Taiwan Semiconductor Manufacturing Co Ltd - ADR (Extended Hours)","",""
"63172058991999","13858.21","-0.18","EURd","SWAP","PROCESSED","2024-05-31 21:06:20","","TSM","Taiwan Semiconductor Manufacturing Co Ltd - ADR (Extended Hours)","",""
"63172031799313","13858.39","-0.21","EURd","SWAP","PROCESSED","2024-05-31 21:05:54","","TSLA","Tesla Inc (Extended Hours)","",""
"63172030746583","13858.6","-0.21","EURd","SWAP","PROCESSED","2024-05-31 21:05:53","","TSLA","Tesla Inc (Extended Hours)","",""
"63172030746311","13858.81","-0.21","EURd","SWAP","PROCESSED","2024-05-31 21:05:53","","TSLA","Tesla Inc (Extended Hours)","",""
"63172030746260","13859.02","-0.43","EURd","SWAP","PROCESSED","2024-05-31 21:05:53","","TSLA","Tesla Inc (Extended Hours)","",""
"63172030746195","13859.45","-0.21","EURd","SWAP","PROCESSED","2024-05-31 21:05:53","","TSLA","Tesla Inc (Extended Hours)","",""
"63172030746147","13859.66","-0.43","EURd","SWAP","PROCESSED","2024-05-31 21:05:53","","TSLA","Tesla Inc (Extended Hours)","",""
"63172030746060","13860.09","-0.43","EURd","SWAP","PROCESSED","2024-05-31 21:05:53","","TSLA","Tesla Inc (Extended Hours)","",""
"63140832378527","13860.52","13.33","EURd","TRADE","PROCESSED","2024-05-31 12:50:00","00001344-0055-311e-0000-4da2000189b6_00001344-0055-311e-0000-0000803e219a","AMD","Advanced Micro Devices Inc (Extended Hours)","",""
"63081462058249","13847.19","-0.2","EURd","SWAP","PROCESSED","2024-05-30 21:06:20","","AMD","Advanced Micro Devices Inc (Extended Hours)","",""
"63081461008993","13847.39","-0.2","EURd","SWAP","PROCESSED","2024-05-30 21:06:19","","AMD","Advanced Micro Devices Inc (Extended Hours)","",""
"63081448397931","13847.59","-0.21","EURd","SWAP","PROCESSED","2024-05-30 21:06:07","","TSLA","Tesla Inc (Extended Hours)","",""
"63081446296815","13847.8","-0.21","EURd","SWAP","PROCESSED","2024-05-30 21:06:05","","TSLA","Tesla Inc (Extended Hours)","",""
"63081446296532","13848.01","-0.21","EURd","SWAP","PROCESSED","2024-05-30 21:06:05","","TSLA","Tesla Inc (Extended Hours)","",""
"63081446296461","13848.22","-0.43","EURd","SWAP","PROCESSED","2024-05-30 21:06:05","","TSLA","Tesla Inc (Extended Hours)","",""
"63081446296401","13848.65","-0.21","EURd","SWAP","PROCESSED","2024-05-30 21:06:05","","TSLA","Tesla Inc (Extended Hours)","",""
"63081446296340","13848.86","-0.43","EURd","SWAP","PROCESSED","2024-05-30 21:06:05","","TSLA","Tesla Inc (Extended Hours)","",""
"63081446296265","13849.29","-0.43","EURd","SWAP","PROCESSED","2024-05-30 21:06:05","","TSLA","Tesla Inc (Extended Hours)","",""
"63081437888979","13849.72","-0.18","EURd","SWAP","PROCESSED","2024-05-30 21:05:57","","TSM","Taiwan Semiconductor Manufacturing Co Ltd - ADR (Extended Hours)","",""
"62990854599719","13849.9","-0.21","EURd","SWAP","PROCESSED","2024-05-29 21:06:10","","TSLA","Tesla Inc (Extended Hours)","",""
"62990853546798","13850.11","-0.21","EURd","SWAP","PROCESSED","2024-05-29 21:06:09","","TSLA","Tesla Inc (Extended Hours)","",""
"62990852497970","13850.32","-0.21","EURd","SWAP","PROCESSED","2024-05-29 21:06:08","","TSLA","Tesla Inc (Extended Hours)","",""
"62990852497924","13850.53","-0.43","EURd","SWAP","PROCESSED","2024-05-29 21:06:08","","TSLA","Tesla Inc (Extended Hours)","",""
"62990852497877","13850.96","-0.21","EURd","SWAP","PROCESSED","2024-05-29 21:06:08","","TSLA","Tesla Inc (Extended Hours)","",""
"62990852497809","13851.17","-0.43","EURd","SWAP","PROCESSED","2024-05-29 21:06:08","","TSLA","Tesla Inc (Extended Hours)","",""
"62990852497766","13851.6","-0.43","EURd","SWAP","PROCESSED","2024-05-29 21:06:08","","TSLA","Tesla Inc (Extended Hours)","",""
"62990845140460","13852.03","-0.19","EURd","SWAP","PROCESSED","2024-05-29 21:06:01","","TSM","Taiwan Semiconductor Manufacturing Co Ltd - ADR (Extended Hours)","",""
"62990816895758","13852.22","-0.2","EURd","SWAP","PROCESSED","2024-05-29 21:05:34","","AMD","Advanced Micro Devices Inc (Extended Hours)","",""
"62990816895076","13852.42","-0.2","EURd","SWAP","PROCESSED","2024-05-29 21:05:34","","AMD","Advanced Micro Devices Inc (Extended Hours)","",""
"62900286940900","13852.62","-0.2","EURd","SWAP","PROCESSED","2024-05-28 21:06:38","","AMD","Advanced Micro Devices Inc (Extended Hours)","",""
"62900271312644","13852.82","-0.19","EURd","SWAP","PROCESSED","2024-05-28 21:06:23","","TSM","Taiwan Semiconductor Manufacturing Co Ltd - ADR (Extended Hours)","",""
"62900217734611","13853.01","-0.21","EURd","SWAP","PROCESSED","2024-05-28 21:05:32","","TSLA","Tesla Inc (Extended Hours)","",""
"62900215632847","13853.22","-0.21","EURd","SWAP","PROCESSED","2024-05-28 21:05:30","","TSLA","Tesla Inc (Extended Hours)","",""
"62900215632551","13853.43","-0.21","EURd","SWAP","PROCESSED","2024-05-28 21:05:30","","TSLA","Tesla Inc (Extended Hours)","",""
"62900214583865","13853.64","-0.42","EURd","SWAP","PROCESSED","2024-05-28 21:05:29","","TSLA","Tesla Inc (Extended Hours)","",""
"62900214583827","13854.06","-0.21","EURd","SWAP","PROCESSED","2024-05-28 21:05:29","","TSLA","Tesla Inc (Extended Hours)","",""
"62900214583757","13854.27","-0.42","EURd","SWAP","PROCESSED","2024-05-28 21:05:29","","TSLA","Tesla Inc (Extended Hours)","",""
"62900214583677","13854.69","-0.42","EURd","SWAP","PROCESSED","2024-05-28 21:05:29","","TSLA","Tesla Inc (Extended Hours)","",""
"62809666919955","13855.11","-0.2","EURd","SWAP","PROCESSED","2024-05-27 21:06:16","","AMD","Advanced Micro Devices Inc (Extended Hours)","",""
"62809652205794","13855.31","-0.21","EURd","SWAP","PROCESSED","2024-05-27 21:06:02","","TSLA","Tesla Inc (Extended Hours)","",""
"62809650104065","13855.52","-0.21","EURd","SWAP","PROCESSED","2024-05-27 21:06:00","","TSLA","Tesla Inc (Extended Hours)","",""
"62809650103842","13855.73","-0.21","EURd","SWAP","PROCESSED","2024-05-27 21:06:00","","TSLA","Tesla Inc (Extended Hours)","",""
"62809650103780","13855.94","-0.43","EURd","SWAP","PROCESSED","2024-05-27 21:06:00","","TSLA","Tesla Inc (Extended Hours)","",""
"62809650103750","13856.37","-0.21","EURd","SWAP","PROCESSED","2024-05-27 21:06:00","","TSLA","Tesla Inc (Extended Hours)","",""
"62809650103691","13856.58","-0.43","EURd","SWAP","PROCESSED","2024-05-27 21:06:00","","TSLA","Tesla Inc (Extended Hours)","",""
"62809650103616","13857.01","-0.43","EURd","SWAP","PROCESSED","2024-05-27 21:06:00","","TSLA","Tesla Inc (Extended Hours)","",""
"62809641827385","13857.44","-0.19","EURd","SWAP","PROCESSED","2024-05-27 21:05:52","","TSM","Taiwan Semiconductor Manufacturing Co Ltd - ADR (Extended Hours)","",""
"62719063724049","13857.63","-0.2","EURd","SWAP","PROCESSED","2024-05-26 21:06:10","","AMD","Advanced Micro Devices Inc (Extended Hours)","",""
"62719054262871","13857.83","-0.21","EURd","SWAP","PROCESSED","2024-05-26 21:06:01","","TSLA","Tesla Inc (Extended Hours)","",""
"62719053209855","13858.04","-0.21","EURd","SWAP","PROCESSED","2024-05-26 21:06:00","","TSLA","Tesla Inc (Extended Hours)","",""
"62719052161051","13858.25","-0.21","EURd","SWAP","PROCESSED","2024-05-26 21:05:59","","TSLA","Tesla Inc (Extended Hours)","",""
"62719052160972","13858.46","-0.43","EURd","SWAP","PROCESSED","2024-05-26 21:05:59","","TSLA","Tesla Inc (Extended Hours)","",""
"62719052160943","13858.89","-0.21","EURd","SWAP","PROCESSED","2024-05-26 21:05:59","","TSLA","Tesla Inc (Extended Hours)","",""
"62719052160867","13859.1","-0.43","EURd","SWAP","PROCESSED","2024-05-26 21:05:59","","TSLA","Tesla Inc (Extended Hours)","",""
"62719052160815","13859.53","-0.43","EURd","SWAP","PROCESSED","2024-05-26 21:05:59","","TSLA","Tesla Inc (Extended Hours)","",""
"62719045852237","13859.96","-0.19","EURd","SWAP","PROCESSED","2024-05-26 21:05:53","","TSM","Taiwan Semiconductor Manufacturing Co Ltd - ADR (Extended Hours)","",""
"62628471993328","13860.15","-0.2","EURd","SWAP","PROCESSED","2024-05-25 21:06:15","","AMD","Advanced Micro Devices Inc (Extended Hours)","",""
"62628464634477","13860.35","-0.21","EURd","SWAP","PROCESSED","2024-05-25 21:06:08","","TSLA","Tesla Inc (Extended Hours)","",""
"62628462532409","13860.56","-0.21","EURd","SWAP","PROCESSED","2024-05-25 21:06:06","","TSLA","Tesla Inc (Extended Hours)","",""
"62628462532172","13860.77","-0.21","EURd","SWAP","PROCESSED","2024-05-25 21:06:06","","TSLA","Tesla Inc (Extended Hours)","",""
"62628462532113","13860.98","-0.43","EURd","SWAP","PROCESSED","2024-05-25 21:06:06","","TSLA","Tesla Inc (Extended Hours)","",""
"62628462532046","13861.41","-0.21","EURd","SWAP","PROCESSED","2024-05-25 21:06:06","","TSLA","Tesla Inc (Extended Hours)","",""
"62628462531999","13861.62","-0.43","EURd","SWAP","PROCESSED","2024-05-25 21:06:06","","TSLA","Tesla Inc (Extended Hours)","",""
"62628462531884","13862.05","-0.43","EURd","SWAP","PROCESSED","2024-05-25 21:06:06","","TSLA","Tesla Inc (Extended Hours)","",""
"62628449917081","13862.48","-0.19","EURd","SWAP","PROCESSED","2024-05-25 21:05:54","","TSM","Taiwan Semiconductor Manufacturing Co Ltd - ADR (Extended Hours)","",""
"62591358630796","13862.67","7.86","EURd","TRADE","PROCESSED","2024-05-25 11:16:21","0015421d-0055-311e-0000-4d9c0004b066_0015421d-0055-311e-0000-0000810fa08e","ETH/USD","Ethereum / USD","",""
"62537884453806","13854.81","-0.53","EURd","SWAP","PROCESSED","2024-05-24 21:06:24","","ETH/USD","Ethereum / USD","",""
"62537869741690","13855.34","-0.19","EURd","SWAP","PROCESSED","2024-05-24 21:06:10","","TSM","Taiwan Semiconductor Manufacturing Co Ltd - ADR (Extended Hours)","",""
"62537827840673","13855.53","-0.21","EURd","SWAP","PROCESSED","2024-05-24 21:05:30","","TSLA","Tesla Inc (Extended Hours)","",""
"62537825738496","13855.74","-0.21","EURd","SWAP","PROCESSED","2024-05-24 21:05:28","","TSLA","Tesla Inc (Extended Hours)","",""
"62537825738304","13855.95","-0.21","EURd","SWAP","PROCESSED","2024-05-24 21:05:28","","TSLA","Tesla Inc (Extended Hours)","",""
"62537825738248","13856.16","-0.43","EURd","SWAP","PROCESSED","2024-05-24 21:05:28","","TSLA","Tesla Inc (Extended Hours)","",""
"62537825738199","13856.59","-0.21","EURd","SWAP","PROCESSED","2024-05-24 21:05:28","","TSLA","Tesla Inc (Extended Hours)","",""
"62537825738112","13856.8","-0.43","EURd","SWAP","PROCESSED","2024-05-24 21:05:28","","TSLA","Tesla Inc (Extended Hours)","",""
"62537825738044","13857.23","-0.43","EURd","SWAP","PROCESSED","2024-05-24 21:05:28","","TSLA","Tesla Inc (Extended Hours)","",""
"62537806824721","13857.66","-0.2","EURd","SWAP","PROCESSED","2024-05-24 21:05:10","","AMD","Advanced Micro Devices Inc (Extended Hours)","",""
"62532794616639","13857.86","4.33","EURd","TRADE","PROCESSED","2024-05-24 19:45:30","00081081-0055-311e-0000-4d9b000ec1e9_00081081-0055-311e-0000-0000803e0357","BABA","Alibaba Group Holding Limited (Extended Hours)","",""
"62532547151983","13853.53","10.69","EURd","TRADE","PROCESSED","2024-05-24 19:41:34","00513301-0055-311e-0000-4d9b000d61a7_00513301-0055-311e-0000-000080b15de7","TSLA","Tesla Inc (Extended Hours)","",""
"62447287497377","13842.84","-0.19","EURd","SWAP","PROCESSED","2024-05-23 21:06:24","","AMD","Advanced Micro Devices Inc (Extended Hours)","",""
"62447275935180","13843.03","-0.21","EURd","SWAP","PROCESSED","2024-05-23 21:06:13","","TSLA","Tesla Inc (Extended Hours)","",""
"62447272784095","13843.24","-0.21","EURd","SWAP","PROCESSED","2024-05-23 21:06:10","","TSLA","Tesla Inc (Extended Hours)","",""
"62447272783838","13843.45","-0.21","EURd","SWAP","PROCESSED","2024-05-23 21:06:10","","TSLA","Tesla Inc (Extended Hours)","",""
"62447272783782","13843.66","-0.43","EURd","SWAP","PROCESSED","2024-05-23 21:06:10","","TSLA","Tesla Inc (Extended Hours)","",""
"62447272783713","13844.09","-0.21","EURd","SWAP","PROCESSED","2024-05-23 21:06:10","","TSLA","Tesla Inc (Extended Hours)","",""
"62447272783659","13844.3","-0.43","EURd","SWAP","PROCESSED","2024-05-23 21:06:10","","TSLA","Tesla Inc (Extended Hours)","",""
"62447272783592","13844.73","-0.43","EURd","SWAP","PROCESSED","2024-05-23 21:06:10","","TSLA","Tesla Inc (Extended Hours)","",""
"62447261224585","13845.16","-0.19","EURd","SWAP","PROCESSED","2024-05-23 21:05:59","","TSM","Taiwan Semiconductor Manufacturing Co Ltd - ADR (Extended Hours)","",""
"62447200413063","13845.35","-0.19","EURd","SWAP","PROCESSED","2024-05-23 21:05:01","","BABA","Alibaba Group Holding Limited (Extended Hours)","",""
"62403870074833","13845.54","5.32","EURd","TRADE","PROCESSED","2024-05-23 09:36:18","000940dd-0055-311e-0000-4d9a000507dc_000940dd-0055-311e-0000-000081f67f07","BTC/USD","Bitcoin / USD","",""
"62403865880503","13840.22","11.3","EURd","TRADE","PROCESSED","2024-05-23 09:36:14","00396101-0055-311e-0000-4d9a0000f152_00396101-0055-311e-0000-000080432fbf","NVDA","NVIDIA Corp (Extended Hours)","",""
"62357216835326","13828.92","95.34","EURd","TRADE","PROCESSED","2024-05-22 21:14:46","00396101-0055-311e-0000-4d990011d050_00396101-0055-311e-0000-0000804317e1","NVDA","NVIDIA Corp (Extended Hours)","",""
"62356690525798","13733.58","-0.2","EURd","SWAP","PROCESSED","2024-05-22 21:06:24","","AMD","Advanced Micro Devices Inc (Extended Hours)","",""
"62356681068669","13733.78","-0.21","EURd","SWAP","PROCESSED","2024-05-22 21:06:15","","TSLA","Tesla Inc (Extended Hours)","",""
"62356677917612","13733.99","-0.21","EURd","SWAP","PROCESSED","2024-05-22 21:06:12","","TSLA","Tesla Inc (Extended Hours)","",""
"62356677917348","13734.2","-0.21","EURd","SWAP","PROCESSED","2024-05-22 21:06:12","","TSLA","Tesla Inc (Extended Hours)","",""
"62356677917297","13734.41","-0.43","EURd","SWAP","PROCESSED","2024-05-22 21:06:12","","TSLA","Tesla Inc (Extended Hours)","",""
"62356677917229","13734.84","-0.21","EURd","SWAP","PROCESSED","2024-05-22 21:06:12","","TSLA","Tesla Inc (Extended Hours)","",""
"62356677917155","13735.05","-0.43","EURd","SWAP","PROCESSED","2024-05-22 21:06:12","","TSLA","Tesla Inc (Extended Hours)","",""
"62356677917072","13735.48","-0.43","EURd","SWAP","PROCESSED","2024-05-22 21:06:12","","TSLA","Tesla Inc (Extended Hours)","",""
"62356609751865","13735.91","-0.48","EURd","SWAP","PROCESSED","2024-05-22 21:05:07","","NVDA","NVIDIA Corp (Extended Hours)","",""
"62266107109353","13736.39","-0.2","EURd","SWAP","PROCESSED","2024-05-21 21:06:37","","AMD","Advanced Micro Devices Inc (Extended Hours)","",""
"62266096732498","13736.59","-0.22","EURd","SWAP","PROCESSED","2024-05-21 21:06:27","","TSLA","Tesla Inc (Extended Hours)","",""
"62266094629424","13736.81","-0.22","EURd","SWAP","PROCESSED","2024-05-21 21:06:25","","TSLA","Tesla Inc (Extended Hours)","",""
"62266094629113","13737.03","-0.22","EURd","SWAP","PROCESSED","2024-05-21 21:06:25","","TSLA","Tesla Inc (Extended Hours)","",""
"62266094629029","13737.25","-0.45","EURd","SWAP","PROCESSED","2024-05-21 21:06:25","","TSLA","Tesla Inc (Extended Hours)","",""
"62266094628973","13737.7","-0.22","EURd","SWAP","PROCESSED","2024-05-21 21:06:25","","TSLA","Tesla Inc (Extended Hours)","",""
"62266094628898","13737.92","-0.45","EURd","SWAP","PROCESSED","2024-05-21 21:06:25","","TSLA","Tesla Inc (Extended Hours)","",""
"62266094628857","13738.37","-0.45","EURd","SWAP","PROCESSED","2024-05-21 21:06:25","","TSLA","Tesla Inc (Extended Hours)","",""
"62266012799305","13738.82","-0.46","EURd","SWAP","PROCESSED","2024-05-21 21:05:07","","NVDA","NVIDIA Corp (Extended Hours)","",""
"62224595085299","13739.28","42.61","EURd","TRADE","PROCESSED","2024-05-21 10:06:48","0015421d-0055-311e-0000-4d980006cc6a_0015421d-0055-311e-0000-000080fe5444","ETH/USD","Ethereum / USD","",""
"62224595085298","13696.67","141.02","EURd","TRADE","PROCESSED","2024-05-21 10:06:48","0015421d-0055-311e-0000-4d980006cc69_0015421d-0055-311e-0000-0000810558c4","ETH/USD","Ethereum / USD","",""
"62175502797522","13555.65","-0.2","EURd","SWAP","PROCESSED","2024-05-20 21:06:30","","AMD","Advanced Micro Devices Inc (Extended Hours)","",""
"62175499776155","13555.85","-0.5","EURd","SWAP","PROCESSED","2024-05-20 21:06:27","","ETH/USD","Ethereum / USD","",""
"62175498725063","13556.35","-0.99","EURd","SWAP","PROCESSED","2024-05-20 21:06:26","","ETH/USD","Ethereum / USD","",""
"62175484016341","13557.34","-0.21","EURd","SWAP","PROCESSED","2024-05-20 21:06:12","","TSLA","Tesla Inc (Extended Hours)","",""
"62175484016019","13557.55","-0.21","EURd","SWAP","PROCESSED","2024-05-20 21:06:12","","TSLA","Tesla Inc (Extended Hours)","",""
"62175484015994","13557.76","-0.42","EURd","SWAP","PROCESSED","2024-05-20 21:06:12","","TSLA","Tesla Inc (Extended Hours)","",""
"62175484015930","13558.18","-0.21","EURd","SWAP","PROCESSED","2024-05-20 21:06:12","","TSLA","Tesla Inc (Extended Hours)","",""
"62175484015872","13558.39","-0.42","EURd","SWAP","PROCESSED","2024-05-20 21:06:12","","TSLA","Tesla Inc (Extended Hours)","",""
"62175484015814","13558.81","-0.42","EURd","SWAP","PROCESSED","2024-05-20 21:06:12","","TSLA","Tesla Inc (Extended Hours)","",""
"62084898499853","13559.23","-0.2","EURd","SWAP","PROCESSED","2024-05-19 21:06:23","","AMD","Advanced Micro Devices Inc (Extended Hours)","",""
"62084895346502","13559.43","-0.43","EURd","SWAP","PROCESSED","2024-05-19 21:06:20","","ETH/USD","Ethereum / USD","",""
"62084894294769","13559.86","-0.87","EURd","SWAP","PROCESSED","2024-05-19 21:06:19","","ETH/USD","Ethereum / USD","",""
"62084881815488","13560.73","-0.21","EURd","SWAP","PROCESSED","2024-05-19 21:06:07","","TSLA","Tesla Inc (Extended Hours)","",""
"62084881815262","13560.94","-0.21","EURd","SWAP","PROCESSED","2024-05-19 21:06:07","","TSLA","Tesla Inc (Extended Hours)","",""
"62084881815182","13561.15","-0.42","EURd","SWAP","PROCESSED","2024-05-19 21:06:07","","TSLA","Tesla Inc (Extended Hours)","",""
"62084881815120","13561.57","-0.21","EURd","SWAP","PROCESSED","2024-05-19 21:06:07","","TSLA","Tesla Inc (Extended Hours)","",""
"62084881815057","13561.78","-0.42","EURd","SWAP","PROCESSED","2024-05-19 21:06:07","","TSLA","Tesla Inc (Extended Hours)","",""
"62084881814974","13562.2","-0.42","EURd","SWAP","PROCESSED","2024-05-19 21:06:07","","TSLA","Tesla Inc (Extended Hours)","",""
"61994299533067","13562.62","-0.2","EURd","SWAP","PROCESSED","2024-05-18 21:06:21","","AMD","Advanced Micro Devices Inc (Extended Hours)","",""
"61994296380819","13562.82","-0.44","EURd","SWAP","PROCESSED","2024-05-18 21:06:18","","ETH/USD","Ethereum / USD","",""
"61994295329427","13563.26","-0.88","EURd","SWAP","PROCESSED","2024-05-18 21:06:17","","ETH/USD","Ethereum / USD","",""
"61994282717773","13564.14","-0.21","EURd","SWAP","PROCESSED","2024-05-18 21:06:05","","TSLA","Tesla Inc (Extended Hours)","",""
"61994282717537","13564.35","-0.21","EURd","SWAP","PROCESSED","2024-05-18 21:06:05","","TSLA","Tesla Inc (Extended Hours)","",""
"61994282717482","13564.56","-0.42","EURd","SWAP","PROCESSED","2024-05-18 21:06:05","","TSLA","Tesla Inc (Extended Hours)","",""
"61994282717419","13564.98","-0.21","EURd","SWAP","PROCESSED","2024-05-18 21:06:05","","TSLA","Tesla Inc (Extended Hours)","",""
"61994282717361","13565.19","-0.42","EURd","SWAP","PROCESSED","2024-05-18 21:06:05","","TSLA","Tesla Inc (Extended Hours)","",""
"61994282717287","13565.61","-0.42","EURd","SWAP","PROCESSED","2024-05-18 21:06:05","","TSLA","Tesla Inc (Extended Hours)","",""
"61903695197674","13566.03","-0.44","EURd","SWAP","PROCESSED","2024-05-17 21:06:14","","ETH/USD","Ethereum / USD","",""
"61903693097408","13566.47","-0.87","EURd","SWAP","PROCESSED","2024-05-17 21:06:12","","ETH/USD","Ethereum / USD","",""
"61903690995032","13567.34","-0.2","EURd","SWAP","PROCESSED","2024-05-17 21:06:10","","AMD","Advanced Micro Devices Inc (Extended Hours)","",""
"61903681535611","13567.54","-0.21","EURd","SWAP","PROCESSED","2024-05-17 21:06:01","","TSLA","Tesla Inc (Extended Hours)","",""
"61903681535295","13567.75","-0.21","EURd","SWAP","PROCESSED","2024-05-17 21:06:01","","TSLA","Tesla Inc (Extended Hours)","",""
"61903681535235","13567.96","-0.42","EURd","SWAP","PROCESSED","2024-05-17 21:06:01","","TSLA","Tesla Inc (Extended Hours)","",""
"61903681535192","13568.38","-0.21","EURd","SWAP","PROCESSED","2024-05-17 21:06:01","","TSLA","Tesla Inc (Extended Hours)","",""
"61903681535135","13568.59","-0.42","EURd","SWAP","PROCESSED","2024-05-17 21:06:01","","TSLA","Tesla Inc (Extended Hours)","",""
"61903681535054","13569.01","-0.42","EURd","SWAP","PROCESSED","2024-05-17 21:06:01","","TSLA","Tesla Inc (Extended Hours)","",""
"61813117050648","13569.43","-0.41","EURd","SWAP","PROCESSED","2024-05-16 21:06:32","","ETH/USD","Ethereum / USD","",""
"61813116000341","13569.84","-0.83","EURd","SWAP","PROCESSED","2024-05-16 21:06:31","","ETH/USD","Ethereum / USD","",""
"61813087753748","13570.67","-0.21","EURd","SWAP","PROCESSED","2024-05-16 21:06:04","","TSLA","Tesla Inc (Extended Hours)","",""
"61813087753502","13570.88","-0.21","EURd","SWAP","PROCESSED","2024-05-16 21:06:04","","TSLA","Tesla Inc (Extended Hours)","",""
"61813087753440","13571.09","-0.42","EURd","SWAP","PROCESSED","2024-05-16 21:06:04","","TSLA","Tesla Inc (Extended Hours)","",""
"61813087753390","13571.51","-0.21","EURd","SWAP","PROCESSED","2024-05-16 21:06:04","","TSLA","Tesla Inc (Extended Hours)","",""
"61813087753345","13571.72","-0.42","EURd","SWAP","PROCESSED","2024-05-16 21:06:04","","TSLA","Tesla Inc (Extended Hours)","",""
"61813087753252","13572.14","-0.42","EURd","SWAP","PROCESSED","2024-05-16 21:06:04","","TSLA","Tesla Inc (Extended Hours)","",""
"61813038490471","13572.56","-0.19","EURd","SWAP","PROCESSED","2024-05-16 21:05:17","","AMD","Advanced Micro Devices Inc (Extended Hours)","",""
"61722516964977","13572.75","-0.43","EURd","SWAP","PROCESSED","2024-05-15 21:06:29","","ETH/USD","Ethereum / USD","",""
"61722515913728","13573.18","-0.85","EURd","SWAP","PROCESSED","2024-05-15 21:06:28","","ETH/USD","Ethereum / USD","",""
"61722514862044","13574.03","-0.19","EURd","SWAP","PROCESSED","2024-05-15 21:06:27","","AMD","Advanced Micro Devices Inc (Extended Hours)","",""
"61722501199985","13574.22","-0.21","EURd","SWAP","PROCESSED","2024-05-15 21:06:14","","TSLA","Tesla Inc (Extended Hours)","",""
"61722501199770","13574.43","-0.21","EURd","SWAP","PROCESSED","2024-05-15 21:06:14","","TSLA","Tesla Inc (Extended Hours)","",""
"61722501199729","13574.64","-0.42","EURd","SWAP","PROCESSED","2024-05-15 21:06:14","","TSLA","Tesla Inc (Extended Hours)","",""
"61722501199668","13575.06","-0.21","EURd","SWAP","PROCESSED","2024-05-15 21:06:14","","TSLA","Tesla Inc (Extended Hours)","",""
"61722501199595","13575.27","-0.42","EURd","SWAP","PROCESSED","2024-05-15 21:06:14","","TSLA","Tesla Inc (Extended Hours)","",""
"61722501199524","13575.69","-0.42","EURd","SWAP","PROCESSED","2024-05-15 21:06:14","","TSLA","Tesla Inc (Extended Hours)","",""
"61631920072907","13576.11","-0.18","EURd","SWAP","PROCESSED","2024-05-14 21:06:29","","AMD","Advanced Micro Devices Inc (Extended Hours)","",""
"61631917971573","13576.29","-0.42","EURd","SWAP","PROCESSED","2024-05-14 21:06:27","","ETH/USD","Ethereum / USD","",""
"61631916919891","13576.71","-0.82","EURd","SWAP","PROCESSED","2024-05-14 21:06:26","","ETH/USD","Ethereum / USD","",""
"61631874882963","13577.53","-0.21","EURd","SWAP","PROCESSED","2024-05-14 21:05:46","","TSLA","Tesla Inc (Extended Hours)","",""
"61631874882757","13577.74","-0.21","EURd","SWAP","PROCESSED","2024-05-14 21:05:46","","TSLA","Tesla Inc (Extended Hours)","",""
"61631874882721","13577.95","-0.43","EURd","SWAP","PROCESSED","2024-05-14 21:05:46","","TSLA","Tesla Inc (Extended Hours)","",""
"61631874882636","13578.38","-0.21","EURd","SWAP","PROCESSED","2024-05-14 21:05:46","","TSLA","Tesla Inc (Extended Hours)","",""
"61631874882599","13578.59","-0.43","EURd","SWAP","PROCESSED","2024-05-14 21:05:46","","TSLA","Tesla Inc (Extended Hours)","",""
"61631874882519","13579.02","-0.43","EURd","SWAP","PROCESSED","2024-05-14 21:05:46","","TSLA","Tesla Inc (Extended Hours)","",""
"61541317818971","13579.45","-0.19","EURd","SWAP","PROCESSED","2024-05-13 21:06:24","","AMD","Advanced Micro Devices Inc (Extended Hours)","",""
"61541315717989","13579.64","-0.43","EURd","SWAP","PROCESSED","2024-05-13 21:06:22","","ETH/USD","Ethereum / USD","",""
"61541313617225","13580.07","-0.84","EURd","SWAP","PROCESSED","2024-05-13 21:06:20","","ETH/USD","Ethereum / USD","",""
"61541302056877","13580.91","-0.2","EURd","SWAP","PROCESSED","2024-05-13 21:06:09","","TSLA","Tesla Inc (Extended Hours)","",""
"61541301008059","13581.11","-0.2","EURd","SWAP","PROCESSED","2024-05-13 21:06:08","","TSLA","Tesla Inc (Extended Hours)","",""
"61541301008000","13581.31","-0.42","EURd","SWAP","PROCESSED","2024-05-13 21:06:08","","TSLA","Tesla Inc (Extended Hours)","",""
"61541301007914","13581.73","-0.2","EURd","SWAP","PROCESSED","2024-05-13 21:06:08","","TSLA","Tesla Inc (Extended Hours)","",""
"61541301007866","13581.93","-0.42","EURd","SWAP","PROCESSED","2024-05-13 21:06:08","","TSLA","Tesla Inc (Extended Hours)","",""
"61541301007808","13582.35","-0.42","EURd","SWAP","PROCESSED","2024-05-13 21:06:08","","TSLA","Tesla Inc (Extended Hours)","",""
"61450709241985","13582.77","-0.19","EURd","SWAP","PROCESSED","2024-05-12 21:06:13","","AMD","Advanced Micro Devices Inc (Extended Hours)","",""
"61450708189720","13582.96","-0.42","EURd","SWAP","PROCESSED","2024-05-12 21:06:12","","ETH/USD","Ethereum / USD","",""
"61450706219938","13583.38","-0.84","EURd","SWAP","PROCESSED","2024-05-12 21:06:10","","ETH/USD","Ethereum / USD","",""
"61450695706484","13584.22","-0.2","EURd","SWAP","PROCESSED","2024-05-12 21:06:00","","TSLA","Tesla Inc (Extended Hours)","",""
"61450695706220","13584.42","-0.2","EURd","SWAP","PROCESSED","2024-05-12 21:06:00","","TSLA","Tesla Inc (Extended Hours)","",""
"61450695706161","13584.62","-0.41","EURd","SWAP","PROCESSED","2024-05-12 21:06:00","","TSLA","Tesla Inc (Extended Hours)","",""
"61450695706082","13585.03","-0.2","EURd","SWAP","PROCESSED","2024-05-12 21:06:00","","TSLA","Tesla Inc (Extended Hours)","",""
"61450695705992","13585.23","-0.41","EURd","SWAP","PROCESSED","2024-05-12 21:06:00","","TSLA","Tesla Inc (Extended Hours)","",""
"61450695705912","13585.64","-0.41","EURd","SWAP","PROCESSED","2024-05-12 21:06:00","","TSLA","Tesla Inc (Extended Hours)","",""
"61360122862343","13586.05","-0.42","EURd","SWAP","PROCESSED","2024-05-11 21:06:23","","ETH/USD","Ethereum / USD","",""
"61360120761199","13586.47","-0.84","EURd","SWAP","PROCESSED","2024-05-11 21:06:21","","ETH/USD","Ethereum / USD","",""
"61360118658550","13587.31","-0.19","EURd","SWAP","PROCESSED","2024-05-11 21:06:19","","AMD","Advanced Micro Devices Inc (Extended Hours)","",""
"61360110252104","13587.5","-0.2","EURd","SWAP","PROCESSED","2024-05-11 21:06:11","","TSLA","Tesla Inc (Extended Hours)","",""
"61360110251858","13587.7","-0.2","EURd","SWAP","PROCESSED","2024-05-11 21:06:11","","TSLA","Tesla Inc (Extended Hours)","",""
"61360110251792","13587.9","-0.41","EURd","SWAP","PROCESSED","2024-05-11 21:06:11","","TSLA","Tesla Inc (Extended Hours)","",""
"61360110251729","13588.31","-0.2","EURd","SWAP","PROCESSED","2024-05-11 21:06:11","","TSLA","Tesla Inc (Extended Hours)","",""
"61360110251673","13588.51","-0.41","EURd","SWAP","PROCESSED","2024-05-11 21:06:11","","TSLA","Tesla Inc (Extended Hours)","",""
"61360110251624","13588.92","-0.41","EURd","SWAP","PROCESSED","2024-05-11 21:06:11","","TSLA","Tesla Inc (Extended Hours)","",""
"61269466094553","13589.33","-0.2","EURd","SWAP","PROCESSED","2024-05-10 21:05:26","","TSLA","Tesla Inc (Extended Hours)","",""
"61269466094312","13589.53","-0.2","EURd","SWAP","PROCESSED","2024-05-10 21:05:26","","TSLA","Tesla Inc (Extended Hours)","",""
"61269466094275","13589.73","-0.41","EURd","SWAP","PROCESSED","2024-05-10 21:05:26","","TSLA","Tesla Inc (Extended Hours)","",""
"61269466094194","13590.14","-0.2","EURd","SWAP","PROCESSED","2024-05-10 21:05:26","","TSLA","Tesla Inc (Extended Hours)","",""
"61269466094142","13590.34","-0.41","EURd","SWAP","PROCESSED","2024-05-10 21:05:26","","TSLA","Tesla Inc (Extended Hours)","",""
"61269466094115","13590.75","-0.41","EURd","SWAP","PROCESSED","2024-05-10 21:05:26","","TSLA","Tesla Inc (Extended Hours)","",""
"61269453486097","13591.16","-0.42","EURd","SWAP","PROCESSED","2024-05-10 21:05:14","","ETH/USD","Ethereum / USD","",""
"61269451384961","13591.58","-0.83","EURd","SWAP","PROCESSED","2024-05-10 21:05:12","","ETH/USD","Ethereum / USD","",""
"61269447181519","13592.41","-0.19","EURd","SWAP","PROCESSED","2024-05-10 21:05:08","","AMD","Advanced Micro Devices Inc (Extended Hours)","",""
"61178919508332","13592.6","-0.44","EURd","SWAP","PROCESSED","2024-05-09 21:06:14","","ETH/USD","Ethereum / USD","",""
"61178918455706","13593.04","-0.86","EURd","SWAP","PROCESSED","2024-05-09 21:06:13","","ETH/USD","Ethereum / USD","",""
"61178916354988","13593.9","-0.19","EURd","SWAP","PROCESSED","2024-05-09 21:06:11","","AMD","Advanced Micro Devices Inc (Extended Hours)","",""
"61178903742937","13594.09","-0.21","EURd","SWAP","PROCESSED","2024-05-09 21:05:59","","TSLA","Tesla Inc (Extended Hours)","",""
"61178903742682","13594.3","-0.21","EURd","SWAP","PROCESSED","2024-05-09 21:05:59","","TSLA","Tesla Inc (Extended Hours)","",""
"61178903742588","13594.51","-0.42","EURd","SWAP","PROCESSED","2024-05-09 21:05:59","","TSLA","Tesla Inc (Extended Hours)","",""
"61178903742523","13594.93","-0.21","EURd","SWAP","PROCESSED","2024-05-09 21:05:59","","TSLA","Tesla Inc (Extended Hours)","",""
"61178903742490","13595.14","-0.42","EURd","SWAP","PROCESSED","2024-05-09 21:05:59","","TSLA","Tesla Inc (Extended Hours)","",""
"61178903742405","13595.56","-0.42","EURd","SWAP","PROCESSED","2024-05-09 21:05:59","","TSLA","Tesla Inc (Extended Hours)","",""
"61088326636174","13595.98","-0.19","EURd","SWAP","PROCESSED","2024-05-08 21:06:18","","AMD","Advanced Micro Devices Inc (Extended Hours)","",""
"61088325585175","13596.17","-0.42","EURd","SWAP","PROCESSED","2024-05-08 21:06:17","","ETH/USD","Ethereum / USD","",""
"61088324532475","13596.59","-0.85","EURd","SWAP","PROCESSED","2024-05-08 21:06:16","","ETH/USD","Ethereum / USD","",""
"61088315204569","13597.44","-0.21","EURd","SWAP","PROCESSED","2024-05-08 21:06:07","","TSLA","Tesla Inc (Extended Hours)","",""
"61088315204356","13597.65","-0.21","EURd","SWAP","PROCESSED","2024-05-08 21:06:07","","TSLA","Tesla Inc (Extended Hours)","",""
"61088315204294","13597.86","-0.43","EURd","SWAP","PROCESSED","2024-05-08 21:06:07","","TSLA","Tesla Inc (Extended Hours)","",""
"61088315204215","13598.29","-0.21","EURd","SWAP","PROCESSED","2024-05-08 21:06:07","","TSLA","Tesla Inc (Extended Hours)","",""
"61088315204116","13598.5","-0.43","EURd","SWAP","PROCESSED","2024-05-08 21:06:07","","TSLA","Tesla Inc (Extended Hours)","",""
"61088315204036","13598.93","-0.43","EURd","SWAP","PROCESSED","2024-05-08 21:06:07","","TSLA","Tesla Inc (Extended Hours)","",""
"60997730748314","13599.36","-0.19","EURd","SWAP","PROCESSED","2024-05-07 21:06:19","","AMD","Advanced Micro Devices Inc (Extended Hours)","",""
"60997729697472","13599.55","-0.44","EURd","SWAP","PROCESSED","2024-05-07 21:06:18","","ETH/USD","Ethereum / USD","",""
"60997727596119","13599.99","-0.87","EURd","SWAP","PROCESSED","2024-05-07 21:06:16","","ETH/USD","Ethereum / USD","",""
"60997714981658","13600.86","-0.21","EURd","SWAP","PROCESSED","2024-05-07 21:06:04","","TSLA","Tesla Inc (Extended Hours)","",""
"60997714981392","13601.07","-0.21","EURd","SWAP","PROCESSED","2024-05-07 21:06:04","","TSLA","Tesla Inc (Extended Hours)","",""
"60997714981345","13601.28","-0.43","EURd","SWAP","PROCESSED","2024-05-07 21:06:04","","TSLA","Tesla Inc (Extended Hours)","",""
"60997714981318","13601.71","-0.21","EURd","SWAP","PROCESSED","2024-05-07 21:06:04","","TSLA","Tesla Inc (Extended Hours)","",""
"60997714981265","13601.92","-0.43","EURd","SWAP","PROCESSED","2024-05-07 21:06:04","","TSLA","Tesla Inc (Extended Hours)","",""
"60997714981214","13602.35","-0.43","EURd","SWAP","PROCESSED","2024-05-07 21:06:04","","TSLA","Tesla Inc (Extended Hours)","",""
"60907148444514","13602.78","-0.44","EURd","SWAP","PROCESSED","2024-05-06 21:06:33","","ETH/USD","Ethereum / USD","",""
"60907146344072","13603.22","-0.88","EURd","SWAP","PROCESSED","2024-05-06 21:06:31","","ETH/USD","Ethereum / USD","",""
"60907141091379","13604.1","-0.19","EURd","SWAP","PROCESSED","2024-05-06 21:06:26","","AMD","Advanced Micro Devices Inc (Extended Hours)","",""
"60907122300186","13604.29","-0.22","EURd","SWAP","PROCESSED","2024-05-06 21:06:08","","TSLA","Tesla Inc (Extended Hours)","",""
"60907122299941","13604.51","-0.22","EURd","SWAP","PROCESSED","2024-05-06 21:06:08","","TSLA","Tesla Inc (Extended Hours)","",""
"60907122299891","13604.73","-0.45","EURd","SWAP","PROCESSED","2024-05-06 21:06:08","","TSLA","Tesla Inc (Extended Hours)","",""
"60907122299825","13605.18","-0.22","EURd","SWAP","PROCESSED","2024-05-06 21:06:08","","TSLA","Tesla Inc (Extended Hours)","",""
"60907122299782","13605.4","-0.45","EURd","SWAP","PROCESSED","2024-05-06 21:06:08","","TSLA","Tesla Inc (Extended Hours)","",""
"60907122299726","13605.85","-0.45","EURd","SWAP","PROCESSED","2024-05-06 21:06:08","","TSLA","Tesla Inc (Extended Hours)","",""
"60816553614515","13606.3","-0.19","EURd","SWAP","PROCESSED","2024-05-05 21:06:35","","AMD","Advanced Micro Devices Inc (Extended Hours)","",""
"60816552564007","13606.49","-0.45","EURd","SWAP","PROCESSED","2024-05-05 21:06:34","","ETH/USD","Ethereum / USD","",""
"60816550464865","13606.94","-0.9","EURd","SWAP","PROCESSED","2024-05-05 21:06:32","","ETH/USD","Ethereum / USD","",""
"60816548363469","13607.84","-0.22","EURd","SWAP","PROCESSED","2024-05-05 21:06:30","","TSLA","Tesla Inc (Extended Hours)","",""
"60816548363326","13608.06","-0.22","EURd","SWAP","PROCESSED","2024-05-05 21:06:30","","TSLA","Tesla Inc (Extended Hours)","",""
"60816548363293","13608.28","-0.44","EURd","SWAP","PROCESSED","2024-05-05 21:06:30","","TSLA","Tesla Inc (Extended Hours)","",""
"60816548363269","13608.72","-0.22","EURd","SWAP","PROCESSED","2024-05-05 21:06:30","","TSLA","Tesla Inc (Extended Hours)","",""
"60816548363230","13608.94","-0.44","EURd","SWAP","PROCESSED","2024-05-05 21:06:30","","TSLA","Tesla Inc (Extended Hours)","",""
"60816548363202","13609.38","-0.44","EURd","SWAP","PROCESSED","2024-05-05 21:06:30","","TSLA","Tesla Inc (Extended Hours)","",""
"60725953463127","13609.82","-0.19","EURd","SWAP","PROCESSED","2024-05-04 21:06:32","","AMD","Advanced Micro Devices Inc (Extended Hours)","",""
"60725952413724","13610.01","-0.45","EURd","SWAP","PROCESSED","2024-05-04 21:06:31","","ETH/USD","Ethereum / USD","",""
"60725951363663","13610.46","-0.89","EURd","SWAP","PROCESSED","2024-05-04 21:06:30","","ETH/USD","Ethereum / USD","",""
"60725935733014","13611.35","-0.22","EURd","SWAP","PROCESSED","2024-05-04 21:06:15","","TSLA","Tesla Inc (Extended Hours)","",""
"60725935732731","13611.57","-0.22","EURd","SWAP","PROCESSED","2024-05-04 21:06:15","","TSLA","Tesla Inc (Extended Hours)","",""
"60725935732643","13611.79","-0.44","EURd","SWAP","PROCESSED","2024-05-04 21:06:15","","TSLA","Tesla Inc (Extended Hours)","",""
"60725935732608","13612.23","-0.22","EURd","SWAP","PROCESSED","2024-05-04 21:06:15","","TSLA","Tesla Inc (Extended Hours)","",""
"60725935732559","13612.45","-0.44","EURd","SWAP","PROCESSED","2024-05-04 21:06:15","","TSLA","Tesla Inc (Extended Hours)","",""
"60725935732514","13612.89","-0.44","EURd","SWAP","PROCESSED","2024-05-04 21:06:15","","TSLA","Tesla Inc (Extended Hours)","",""
"60635292609060","13613.33","-0.19","EURd","SWAP","PROCESSED","2024-05-03 21:05:31","","AMD","Advanced Micro Devices Inc (Extended Hours)","",""
"60635282097624","13613.52","-0.45","EURd","SWAP","PROCESSED","2024-05-03 21:05:21","","ETH/USD","Ethereum / USD","",""
"60635279995496","13613.97","-0.89","EURd","SWAP","PROCESSED","2024-05-03 21:05:19","","ETH/USD","Ethereum / USD","",""
"60635268436289","13614.86","-0.22","EURd","SWAP","PROCESSED","2024-05-03 21:05:08","","TSLA","Tesla Inc (Extended Hours)","",""
"60635268436076","13615.08","-0.22","EURd","SWAP","PROCESSED","2024-05-03 21:05:08","","TSLA","Tesla Inc (Extended Hours)","",""
"60635268436011","13615.3","-0.44","EURd","SWAP","PROCESSED","2024-05-03 21:05:08","","TSLA","Tesla Inc (Extended Hours)","",""
"60635268435930","13615.74","-0.22","EURd","SWAP","PROCESSED","2024-05-03 21:05:08","","TSLA","Tesla Inc (Extended Hours)","",""
"60635268435886","13615.96","-0.44","EURd","SWAP","PROCESSED","2024-05-03 21:05:08","","TSLA","Tesla Inc (Extended Hours)","",""
"60635268435833","13616.4","-0.44","EURd","SWAP","PROCESSED","2024-05-03 21:05:08","","TSLA","Tesla Inc (Extended Hours)","",""
"60544756464164","13616.84","-0.43","EURd","SWAP","PROCESSED","2024-05-02 21:06:29","","ETH/USD","Ethereum / USD","",""
"60544755412266","13617.27","-0.86","EURd","SWAP","PROCESSED","2024-05-02 21:06:28","","ETH/USD","Ethereum / USD","",""
"60544722831647","13618.13","-0.22","EURd","SWAP","PROCESSED","2024-05-02 21:05:57","","TSLA","Tesla Inc (Extended Hours)","",""
"60544722831369","13618.35","-0.22","EURd","SWAP","PROCESSED","2024-05-02 21:05:57","","TSLA","Tesla Inc (Extended Hours)","",""
"60544722831304","13618.57","-0.44","EURd","SWAP","PROCESSED","2024-05-02 21:05:57","","TSLA","Tesla Inc (Extended Hours)","",""
"60544722831230","13619.01","-0.22","EURd","SWAP","PROCESSED","2024-05-02 21:05:57","","TSLA","Tesla Inc (Extended Hours)","",""
"60544722831194","13619.23","-0.44","EURd","SWAP","PROCESSED","2024-05-02 21:05:57","","TSLA","Tesla Inc (Extended Hours)","",""
"60544722831135","13619.67","-0.44","EURd","SWAP","PROCESSED","2024-05-02 21:05:57","","TSLA","Tesla Inc (Extended Hours)","",""
"60544671466056","13620.11","-0.18","EURd","SWAP","PROCESSED","2024-05-02 21:05:08","","AMD","Advanced Micro Devices Inc (Extended Hours)","",""
"60454161593216","13620.29","-0.42","EURd","SWAP","PROCESSED","2024-05-01 21:06:31","","ETH/USD","Ethereum / USD","",""
"60454159492681","13620.71","-0.85","EURd","SWAP","PROCESSED","2024-05-01 21:06:29","","ETH/USD","Ethereum / USD","",""
"60454134268756","13621.56","-0.22","EURd","SWAP","PROCESSED","2024-05-01 21:06:05","","TSLA","Tesla Inc (Extended Hours)","",""
"60454134268481","13621.78","-0.22","EURd","SWAP","PROCESSED","2024-05-01 21:06:05","","TSLA","Tesla Inc (Extended Hours)","",""
"60454134268437","13622","-0.44","EURd","SWAP","PROCESSED","2024-05-01 21:06:05","","TSLA","Tesla Inc (Extended Hours)","",""
"60454134268391","13622.44","-0.22","EURd","SWAP","PROCESSED","2024-05-01 21:06:05","","TSLA","Tesla Inc (Extended Hours)","",""
"60454134268304","13622.66","-0.44","EURd","SWAP","PROCESSED","2024-05-01 21:06:05","","TSLA","Tesla Inc (Extended Hours)","",""
"60454134268256","13623.1","-0.44","EURd","SWAP","PROCESSED","2024-05-01 21:06:05","","TSLA","Tesla Inc (Extended Hours)","",""
"60454133216603","13623.54","-0.18","EURd","SWAP","PROCESSED","2024-05-01 21:06:03","","AMD","Advanced Micro Devices Inc (Extended Hours)","",""
"60363557262731","13623.72","-0.43","EURd","SWAP","PROCESSED","2024-04-30 21:06:24","","ETH/USD","Ethereum / USD","",""
"60363555161300","13624.15","-0.86","EURd","SWAP","PROCESSED","2024-04-30 21:06:22","","ETH/USD","Ethereum / USD","",""
"60363502737797","13625.01","-0.22","EURd","SWAP","PROCESSED","2024-04-30 21:05:32","","TSLA","Tesla Inc (Extended Hours)","",""
"60363501688971","13625.23","-0.22","EURd","SWAP","PROCESSED","2024-04-30 21:05:31","","TSLA","Tesla Inc (Extended Hours)","",""
"60363501688917","13625.45","-0.44","EURd","SWAP","PROCESSED","2024-04-30 21:05:31","","TSLA","Tesla Inc (Extended Hours)","",""
"60363501688852","13625.89","-0.22","EURd","SWAP","PROCESSED","2024-04-30 21:05:31","","TSLA","Tesla Inc (Extended Hours)","",""
"60363501688814","13626.11","-0.44","EURd","SWAP","PROCESSED","2024-04-30 21:05:31","","TSLA","Tesla Inc (Extended Hours)","",""
"60363501688769","13626.55","-0.44","EURd","SWAP","PROCESSED","2024-04-30 21:05:31","","TSLA","Tesla Inc (Extended Hours)","",""
"60363500636349","13626.99","-0.19","EURd","SWAP","PROCESSED","2024-04-30 21:05:30","","AMD","Advanced Micro Devices Inc (Extended Hours)","",""
"60278267169658","13627.18","15.18","EURd","TRADE","PROCESSED","2024-04-29 22:30:45","0015421d-0055-311e-0000-4d8200104c15_0015421d-0055-311e-0000-000081054c0f","ETH/USD","Ethereum / USD","",""
"60272918367807","13612","-0.46","EURd","SWAP","PROCESSED","2024-04-29 21:05:44","","ETH/USD","Ethereum / USD","",""
"60272914167533","13612.46","-0.91","EURd","SWAP","PROCESSED","2024-04-29 21:05:40","","ETH/USD","Ethereum / USD","",""
"60272879482733","13613.37","-0.23","EURd","SWAP","PROCESSED","2024-04-29 21:05:07","","TSLA","Tesla Inc (Extended Hours)","",""
"60272879482443","13613.6","-0.23","EURd","SWAP","PROCESSED","2024-04-29 21:05:07","","TSLA","Tesla Inc (Extended Hours)","",""
"60272879482404","13613.83","-0.48","EURd","SWAP","PROCESSED","2024-04-29 21:05:07","","TSLA","Tesla Inc (Extended Hours)","",""
"60272879482367","13614.31","-0.23","EURd","SWAP","PROCESSED","2024-04-29 21:05:07","","TSLA","Tesla Inc (Extended Hours)","",""
"60272879482305","13614.54","-0.48","EURd","SWAP","PROCESSED","2024-04-29 21:05:07","","TSLA","Tesla Inc (Extended Hours)","",""
"60272879482226","13615.02","-0.48","EURd","SWAP","PROCESSED","2024-04-29 21:05:07","","TSLA","Tesla Inc (Extended Hours)","",""
"60272876331706","13615.5","-0.2","EURd","SWAP","PROCESSED","2024-04-29 21:05:04","","AMD","Advanced Micro Devices Inc (Extended Hours)","",""
"60244278593442","13615.7","12.29","EURd","TRADE","PROCESSED","2024-04-29 13:30:31","00001344-0055-311e-0000-4d8200028931_00001344-0055-311e-0000-00008035b082","AMD","Advanced Micro Devices Inc (Extended Hours)","",""
"60182370683455","13603.41","-0.95","EURd","SWAP","PROCESSED","2024-04-28 21:06:31","","ETH/USD","Ethereum / USD","",""
"60182364379435","13604.36","-0.21","EURd","SWAP","PROCESSED","2024-04-28 21:06:25","","TSLA","Tesla Inc (Extended Hours)","",""
"60182364379270","13604.57","-0.21","EURd","SWAP","PROCESSED","2024-04-28 21:06:25","","TSLA","Tesla Inc (Extended Hours)","",""
"60182364379235","13604.78","-0.41","EURd","SWAP","PROCESSED","2024-04-28 21:06:25","","TSLA","Tesla Inc (Extended Hours)","",""
"60182364379194","13605.19","-0.21","EURd","SWAP","PROCESSED","2024-04-28 21:06:25","","TSLA","Tesla Inc (Extended Hours)","",""
"60182364379166","13605.4","-0.41","EURd","SWAP","PROCESSED","2024-04-28 21:06:25","","TSLA","Tesla Inc (Extended Hours)","",""
"60182364379101","13605.81","-0.41","EURd","SWAP","PROCESSED","2024-04-28 21:06:25","","TSLA","Tesla Inc (Extended Hours)","",""
"60182362277637","13606.22","-0.2","EURd","SWAP","PROCESSED","2024-04-28 21:06:23","","AMD","Advanced Micro Devices Inc (Extended Hours)","",""
"60182361226220","13606.42","-0.2","EURd","SWAP","PROCESSED","2024-04-28 21:06:22","","AMD","Advanced Micro Devices Inc (Extended Hours)","",""
"60091777872010","13606.62","-0.94","EURd","SWAP","PROCESSED","2024-04-27 21:06:35","","ETH/USD","Ethereum / USD","",""
"60091775772460","13607.56","-0.2","EURd","SWAP","PROCESSED","2024-04-27 21:06:33","","AMD","Advanced Micro Devices Inc (Extended Hours)","",""
"60091775772152","13607.76","-0.2","EURd","SWAP","PROCESSED","2024-04-27 21:06:33","","AMD","Advanced Micro Devices Inc (Extended Hours)","",""
"60091754752578","13607.96","-0.21","EURd","SWAP","PROCESSED","2024-04-27 21:06:13","","TSLA","Tesla Inc (Extended Hours)","",""
"60091754752278","13608.17","-0.21","EURd","SWAP","PROCESSED","2024-04-27 21:06:13","","TSLA","Tesla Inc (Extended Hours)","",""
"60091754752211","13608.38","-0.41","EURd","SWAP","PROCESSED","2024-04-27 21:06:13","","TSLA","Tesla Inc (Extended Hours)","",""
"60091753703575","13608.79","-0.21","EURd","SWAP","PROCESSED","2024-04-27 21:06:12","","TSLA","Tesla Inc (Extended Hours)","",""
"60091753703514","13609","-0.41","EURd","SWAP","PROCESSED","2024-04-27 21:06:12","","TSLA","Tesla Inc (Extended Hours)","",""
"60091753703436","13609.41","-0.41","EURd","SWAP","PROCESSED","2024-04-27 21:06:12","","TSLA","Tesla Inc (Extended Hours)","",""
"60001177706305","13609.82","-0.2","EURd","SWAP","PROCESSED","2024-04-26 21:06:32","","AMD","Advanced Micro Devices Inc (Extended Hours)","",""
"60001177705901","13610.02","-0.2","EURd","SWAP","PROCESSED","2024-04-26 21:06:32","","AMD","Advanced Micro Devices Inc (Extended Hours)","",""
"60001175604234","13610.22","-0.91","EURd","SWAP","PROCESSED","2024-04-26 21:06:30","","ETH/USD","Ethereum / USD","",""
"60001169427372","13611.13","-0.21","EURd","SWAP","PROCESSED","2024-04-26 21:06:24","","TSLA","Tesla Inc (Extended Hours)","",""
"60001169427129","13611.34","-0.21","EURd","SWAP","PROCESSED","2024-04-26 21:06:24","","TSLA","Tesla Inc (Extended Hours)","",""
"60001168378487","13611.55","-0.41","EURd","SWAP","PROCESSED","2024-04-26 21:06:23","","TSLA","Tesla Inc (Extended Hours)","",""
"60001168378442","13611.96","-0.21","EURd","SWAP","PROCESSED","2024-04-26 21:06:23","","TSLA","Tesla Inc (Extended Hours)","",""
"60001168378395","13612.17","-0.41","EURd","SWAP","PROCESSED","2024-04-26 21:06:23","","TSLA","Tesla Inc (Extended Hours)","",""
"60001168378333","13612.58","-0.41","EURd","SWAP","PROCESSED","2024-04-26 21:06:23","","TSLA","Tesla Inc (Extended Hours)","",""
"59952336126452","13612.99","28.97","EURd","TRADE","PROCESSED","2024-04-26 08:10:13","00081081-0055-311e-0000-4d7f0000a0f1_00081081-0055-311e-0000-000080350055","BABA","Alibaba Group Holding Limited (Extended Hours)","",""
"59910582887077","13584.02","-0.91","EURd","SWAP","PROCESSED","2024-04-25 21:06:34","","ETH/USD","Ethereum / USD","",""
"59910579734113","13584.93","-0.19","EURd","SWAP","PROCESSED","2024-04-25 21:06:31","","AMD","Advanced Micro Devices Inc (Extended Hours)","",""
"59910555693790","13585.12","-0.21","EURd","SWAP","PROCESSED","2024-04-25 21:06:08","","TSLA","Tesla Inc (Extended Hours)","",""
"59910555693515","13585.33","-0.21","EURd","SWAP","PROCESSED","2024-04-25 21:06:08","","TSLA","Tesla Inc (Extended Hours)","",""
"59910555693458","13585.54","-0.42","EURd","SWAP","PROCESSED","2024-04-25 21:06:08","","TSLA","Tesla Inc (Extended Hours)","",""
"59910555693406","13585.96","-0.21","EURd","SWAP","PROCESSED","2024-04-25 21:06:08","","TSLA","Tesla Inc (Extended Hours)","",""
"59910555693353","13586.17","-0.42","EURd","SWAP","PROCESSED","2024-04-25 21:06:08","","TSLA","Tesla Inc (Extended Hours)","",""
"59910555693301","13586.59","-0.42","EURd","SWAP","PROCESSED","2024-04-25 21:06:08","","TSLA","Tesla Inc (Extended Hours)","",""
"59910494871255","13587.01","-0.19","EURd","SWAP","PROCESSED","2024-04-25 21:05:10","","BABA","Alibaba Group Holding Limited (Extended Hours)","",""
"59819979618657","13587.2","-0.19","EURd","SWAP","PROCESSED","2024-04-24 21:06:28","","AMD","Advanced Micro Devices Inc (Extended Hours)","",""
"59819973312415","13587.39","-0.91","EURd","SWAP","PROCESSED","2024-04-24 21:06:22","","ETH/USD","Ethereum / USD","",""
"59819948216830","13588.3","-0.2","EURd","SWAP","PROCESSED","2024-04-24 21:05:58","","TSLA","Tesla Inc (Extended Hours)","",""
"59819948216552","13588.5","-0.2","EURd","SWAP","PROCESSED","2024-04-24 21:05:58","","TSLA","Tesla Inc (Extended Hours)","",""
"59819948216457","13588.7","-0.39","EURd","SWAP","PROCESSED","2024-04-24 21:05:58","","TSLA","Tesla Inc (Extended Hours)","",""
"59819948216400","13589.09","-0.2","EURd","SWAP","PROCESSED","2024-04-24 21:05:58","","TSLA","Tesla Inc (Extended Hours)","",""
"59819948216341","13589.29","-0.39","EURd","SWAP","PROCESSED","2024-04-24 21:05:58","","TSLA","Tesla Inc (Extended Hours)","",""
"59819948216274","13589.68","-0.39","EURd","SWAP","PROCESSED","2024-04-24 21:05:58","","TSLA","Tesla Inc (Extended Hours)","",""
"59819897900089","13590.07","-0.18","EURd","SWAP","PROCESSED","2024-04-24 21:05:10","","BABA","Alibaba Group Holding Limited (Extended Hours)","",""
"59729372152028","13590.25","-0.19","EURd","SWAP","PROCESSED","2024-04-23 21:06:18","","TSLA","Tesla Inc (Extended Hours)","",""
"59729372151812","13590.44","-0.19","EURd","SWAP","PROCESSED","2024-04-23 21:06:18","","TSLA","Tesla Inc (Extended Hours)","",""
"59729372151696","13590.63","-0.38","EURd","SWAP","PROCESSED","2024-04-23 21:06:18","","TSLA","Tesla Inc (Extended Hours)","",""
"59729372151606","13591.01","-0.19","EURd","SWAP","PROCESSED","2024-04-23 21:06:18","","TSLA","Tesla Inc (Extended Hours)","",""
"59729372151530","13591.2","-0.38","EURd","SWAP","PROCESSED","2024-04-23 21:06:18","","TSLA","Tesla Inc (Extended Hours)","",""
"59729372151482","13591.58","-0.38","EURd","SWAP","PROCESSED","2024-04-23 21:06:18","","TSLA","Tesla Inc (Extended Hours)","",""
"59729328137310","13591.96","-0.19","EURd","SWAP","PROCESSED","2024-04-23 21:05:36","","AMD","Advanced Micro Devices Inc (Extended Hours)","",""
"59729305012583","13592.15","-0.93","EURd","SWAP","PROCESSED","2024-04-23 21:05:14","","ETH/USD","Ethereum / USD","",""
"59729293585175","13593.08","-0.18","EURd","SWAP","PROCESSED","2024-04-23 21:05:03","","BABA","Alibaba Group Holding Limited (Extended Hours)","",""
"59638794083159","13593.26","-0.92","EURd","SWAP","PROCESSED","2024-04-22 21:06:36","","ETH/USD","Ethereum / USD","",""
"59638756380113","13594.18","-0.18","EURd","SWAP","PROCESSED","2024-04-22 21:06:00","","AMD","Advanced Micro Devices Inc (Extended Hours)","",""
"59638734309704","13594.36","-0.18","EURd","SWAP","PROCESSED","2024-04-22 21:05:39","","TSLA","Tesla Inc (Extended Hours)","",""
"59638734309461","13594.54","-0.18","EURd","SWAP","PROCESSED","2024-04-22 21:05:39","","TSLA","Tesla Inc (Extended Hours)","",""
"59638734309411","13594.72","-0.35","EURd","SWAP","PROCESSED","2024-04-22 21:05:39","","TSLA","Tesla Inc (Extended Hours)","",""
"59638733260679","13595.07","-0.18","EURd","SWAP","PROCESSED","2024-04-22 21:05:38","","TSLA","Tesla Inc (Extended Hours)","",""
"59638733260604","13595.25","-0.35","EURd","SWAP","PROCESSED","2024-04-22 21:05:38","","TSLA","Tesla Inc (Extended Hours)","",""
"59638733260561","13595.6","-0.35","EURd","SWAP","PROCESSED","2024-04-22 21:05:38","","TSLA","Tesla Inc (Extended Hours)","",""
"59638694505499","13595.95","-0.17","EURd","SWAP","PROCESSED","2024-04-22 21:05:01","","BABA","Alibaba Group Holding Limited (Extended Hours)","",""
"59548191879800","13596.12","-0.18","EURd","SWAP","PROCESSED","2024-04-21 21:06:31","","TSLA","Tesla Inc (Extended Hours)","",""
"59548191879716","13596.3","-0.18","EURd","SWAP","PROCESSED","2024-04-21 21:06:31","","TSLA","Tesla Inc (Extended Hours)","",""
"59548191879692","13596.48","-0.36","EURd","SWAP","PROCESSED","2024-04-21 21:06:31","","TSLA","Tesla Inc (Extended Hours)","",""
"59548191879673","13596.84","-0.18","EURd","SWAP","PROCESSED","2024-04-21 21:06:31","","TSLA","Tesla Inc (Extended Hours)","",""
"59548191879650","13597.02","-0.36","EURd","SWAP","PROCESSED","2024-04-21 21:06:31","","TSLA","Tesla Inc (Extended Hours)","",""
"59548191879630","13597.38","-0.36","EURd","SWAP","PROCESSED","2024-04-21 21:06:31","","TSLA","Tesla Inc (Extended Hours)","",""
"59548175065595","13597.74","-0.91","EURd","SWAP","PROCESSED","2024-04-21 21:06:15","","ETH/USD","Ethereum / USD","",""
"59548129995278","13598.65","-0.18","EURd","SWAP","PROCESSED","2024-04-21 21:05:32","","AMD","Advanced Micro Devices Inc (Extended Hours)","",""
"59548105952600","13598.83","-0.17","EURd","SWAP","PROCESSED","2024-04-21 21:05:09","","BABA","Alibaba Group Holding Limited (Extended Hours)","",""
"59457593823120","13599","-0.18","EURd","SWAP","PROCESSED","2024-04-20 21:06:30","","TSLA","Tesla Inc (Extended Hours)","",""
"59457593823031","13599.18","-0.18","EURd","SWAP","PROCESSED","2024-04-20 21:06:30","","TSLA","Tesla Inc (Extended Hours)","",""
"59457593823012","13599.36","-0.36","EURd","SWAP","PROCESSED","2024-04-20 21:06:30","","TSLA","Tesla Inc (Extended Hours)","",""
"59457593822988","13599.72","-0.18","EURd","SWAP","PROCESSED","2024-04-20 21:06:30","","TSLA","Tesla Inc (Extended Hours)","",""
"59457593822968","13599.9","-0.36","EURd","SWAP","PROCESSED","2024-04-20 21:06:30","","TSLA","Tesla Inc (Extended Hours)","",""
"59457593822946","13600.26","-0.36","EURd","SWAP","PROCESSED","2024-04-20 21:06:30","","TSLA","Tesla Inc (Extended Hours)","",""
"59457575037507","13600.62","-0.91","EURd","SWAP","PROCESSED","2024-04-20 21:06:12","","ETH/USD","Ethereum / USD","",""
"59457559266852","13601.53","-0.18","EURd","SWAP","PROCESSED","2024-04-20 21:05:57","","AMD","Advanced Micro Devices Inc (Extended Hours)","",""
"59457531018278","13601.71","-0.17","EURd","SWAP","PROCESSED","2024-04-20 21:05:30","","BABA","Alibaba Group Holding Limited (Extended Hours)","",""
"59366992732440","13601.88","-0.89","EURd","SWAP","PROCESSED","2024-04-19 21:06:26","","ETH/USD","Ethereum / USD","",""
"59366972759645","13602.77","-0.18","EURd","SWAP","PROCESSED","2024-04-19 21:06:07","","TSLA","Tesla Inc (Extended Hours)","",""
"59366972759403","13602.95","-0.18","EURd","SWAP","PROCESSED","2024-04-19 21:06:07","","TSLA","Tesla Inc (Extended Hours)","",""
"59366971710762","13603.13","-0.36","EURd","SWAP","PROCESSED","2024-04-19 21:06:06","","TSLA","Tesla Inc (Extended Hours)","",""
"59366971710663","13603.49","-0.18","EURd","SWAP","PROCESSED","2024-04-19 21:06:06","","TSLA","Tesla Inc (Extended Hours)","",""
"59366971710583","13603.67","-0.36","EURd","SWAP","PROCESSED","2024-04-19 21:06:06","","TSLA","Tesla Inc (Extended Hours)","",""
"59366971710501","13604.03","-0.36","EURd","SWAP","PROCESSED","2024-04-19 21:06:06","","TSLA","Tesla Inc (Extended Hours)","",""
"59366970658139","13604.39","-0.18","EURd","SWAP","PROCESSED","2024-04-19 21:06:05","","AMD","Advanced Micro Devices Inc (Extended Hours)","",""
"59366904573305","13604.57","-0.17","EURd","SWAP","PROCESSED","2024-04-19 21:05:02","","BABA","Alibaba Group Holding Limited (Extended Hours)","",""
"59276392519693","13604.74","-0.19","EURd","SWAP","PROCESSED","2024-04-18 21:06:23","","AMD","Advanced Micro Devices Inc (Extended Hours)","",""
"59276363159828","13604.93","-0.19","EURd","SWAP","PROCESSED","2024-04-18 21:05:55","","TSLA","Tesla Inc (Extended Hours)","",""
"59276362110995","13605.12","-0.19","EURd","SWAP","PROCESSED","2024-04-18 21:05:54","","TSLA","Tesla Inc (Extended Hours)","",""
"59276362110943","13605.31","-0.37","EURd","SWAP","PROCESSED","2024-04-18 21:05:54","","TSLA","Tesla Inc (Extended Hours)","",""
"59276362110876","13605.68","-0.19","EURd","SWAP","PROCESSED","2024-04-18 21:05:54","","TSLA","Tesla Inc (Extended Hours)","",""
"59276362110828","13605.87","-0.37","EURd","SWAP","PROCESSED","2024-04-18 21:05:54","","TSLA","Tesla Inc (Extended Hours)","",""
"59276362110767","13606.24","-0.37","EURd","SWAP","PROCESSED","2024-04-18 21:05:54","","TSLA","Tesla Inc (Extended Hours)","",""
"59276330648671","13606.61","-0.89","EURd","SWAP","PROCESSED","2024-04-18 21:05:24","","ETH/USD","Ethereum / USD","",""
"59276306545662","13607.5","-0.17","EURd","SWAP","PROCESSED","2024-04-18 21:05:01","","BABA","Alibaba Group Holding Limited (Extended Hours)","",""
"59185804982200","13607.67","-0.86","EURd","SWAP","PROCESSED","2024-04-17 21:06:32","","ETH/USD","Ethereum / USD","",""
"59185794474288","13608.53","-0.19","EURd","SWAP","PROCESSED","2024-04-17 21:06:22","","AMD","Advanced Micro Devices Inc (Extended Hours)","",""
"59185768258554","13608.72","-0.19","EURd","SWAP","PROCESSED","2024-04-17 21:05:57","","TSLA","Tesla Inc (Extended Hours)","",""
"59185768258255","13608.91","-0.19","EURd","SWAP","PROCESSED","2024-04-17 21:05:57","","TSLA","Tesla Inc (Extended Hours)","",""
"59185768258212","13609.1","-0.38","EURd","SWAP","PROCESSED","2024-04-17 21:05:57","","TSLA","Tesla Inc (Extended Hours)","",""
"59185768258125","13609.48","-0.19","EURd","SWAP","PROCESSED","2024-04-17 21:05:57","","TSLA","Tesla Inc (Extended Hours)","",""
"59185768258033","13609.67","-0.38","EURd","SWAP","PROCESSED","2024-04-17 21:05:57","","TSLA","Tesla Inc (Extended Hours)","",""
"59185768257941","13610.05","-0.38","EURd","SWAP","PROCESSED","2024-04-17 21:05:57","","TSLA","Tesla Inc (Extended Hours)","",""
"59185709534781","13610.43","-0.17","EURd","SWAP","PROCESSED","2024-04-17 21:05:01","","BABA","Alibaba Group Holding Limited (Extended Hours)","",""
"59095223741596","13610.6","-0.89","EURd","SWAP","PROCESSED","2024-04-16 21:06:47","","ETH/USD","Ethereum / USD","",""
"59095198592533","13611.49","-0.2","EURd","SWAP","PROCESSED","2024-04-16 21:06:23","","AMD","Advanced Micro Devices Inc (Extended Hours)","",""
"59095145066708","13611.69","-0.17","EURd","SWAP","PROCESSED","2024-04-16 21:05:32","","BABA","Alibaba Group Holding Limited (Extended Hours)","",""
"59095128317794","13611.86","-0.2","EURd","SWAP","PROCESSED","2024-04-16 21:05:16","","TSLA","Tesla Inc (Extended Hours)","",""
"59095128317622","13612.06","-0.2","EURd","SWAP","PROCESSED","2024-04-16 21:05:16","","TSLA","Tesla Inc (Extended Hours)","",""
"59095127268994","13612.26","-0.39","EURd","SWAP","PROCESSED","2024-04-16 21:05:15","","TSLA","Tesla Inc (Extended Hours)","",""
"59095127268934","13612.65","-0.2","EURd","SWAP","PROCESSED","2024-04-16 21:05:15","","TSLA","Tesla Inc (Extended Hours)","",""
"59095127268881","13612.85","-0.39","EURd","SWAP","PROCESSED","2024-04-16 21:05:15","","TSLA","Tesla Inc (Extended Hours)","",""
"59095127268766","13613.24","-0.39","EURd","SWAP","PROCESSED","2024-04-16 21:05:15","","TSLA","Tesla Inc (Extended Hours)","",""
"59004627803568","13613.63","-0.18","EURd","SWAP","PROCESSED","2024-04-15 21:06:48","","BABA","Alibaba Group Holding Limited (Extended Hours)","",""
"59004622555584","13613.81","-0.89","EURd","SWAP","PROCESSED","2024-04-15 21:06:43","","ETH/USD","Ethereum / USD","",""
"59004581642684","13614.7","-0.2","EURd","SWAP","PROCESSED","2024-04-15 21:06:04","","TSLA","Tesla Inc (Extended Hours)","",""
"59004581642458","13614.9","-0.2","EURd","SWAP","PROCESSED","2024-04-15 21:06:04","","TSLA","Tesla Inc (Extended Hours)","",""
"59004581642402","13615.1","-0.4","EURd","SWAP","PROCESSED","2024-04-15 21:06:04","","TSLA","Tesla Inc (Extended Hours)","",""
"59004581642332","13615.5","-0.2","EURd","SWAP","PROCESSED","2024-04-15 21:06:04","","TSLA","Tesla Inc (Extended Hours)","",""
"59004581642265","13615.7","-0.4","EURd","SWAP","PROCESSED","2024-04-15 21:06:04","","TSLA","Tesla Inc (Extended Hours)","",""
"59004581707430","13616.1","-0.4","EURd","SWAP","PROCESSED","2024-04-15 21:06:04","","TSLA","Tesla Inc (Extended Hours)","",""
"59004561739078","13616.5","-0.2","EURd","SWAP","PROCESSED","2024-04-15 21:05:45","","AMD","Advanced Micro Devices Inc (Extended Hours)","",""
"58914036109118","13616.7","-0.88","EURd","SWAP","PROCESSED","2024-04-14 21:06:53","","ETH/USD","Ethereum / USD","",""
"58914004656176","13617.58","-0.22","EURd","SWAP","PROCESSED","2024-04-14 21:06:23","","TSLA","Tesla Inc (Extended Hours)","",""
"58914004655900","13617.8","-0.22","EURd","SWAP","PROCESSED","2024-04-14 21:06:23","","TSLA","Tesla Inc (Extended Hours)","",""
"58914004655667","13618.02","-0.42","EURd","SWAP","PROCESSED","2024-04-14 21:06:23","","TSLA","Tesla Inc (Extended Hours)","",""
"58914004655598","13618.44","-0.22","EURd","SWAP","PROCESSED","2024-04-14 21:06:23","","TSLA","Tesla Inc (Extended Hours)","",""
"58914004655465","13618.66","-0.42","EURd","SWAP","PROCESSED","2024-04-14 21:06:23","","TSLA","Tesla Inc (Extended Hours)","",""
"58914004655105","13619.08","-0.42","EURd","SWAP","PROCESSED","2024-04-14 21:06:23","","TSLA","Tesla Inc (Extended Hours)","",""
"58914001501986","13619.5","-0.2","EURd","SWAP","PROCESSED","2024-04-14 21:06:20","","AMD","Advanced Micro Devices Inc (Extended Hours)","",""
"58913968994414","13619.7","-0.18","EURd","SWAP","PROCESSED","2024-04-14 21:05:49","","BABA","Alibaba Group Holding Limited (Extended Hours)","",""
"58823396105232","13619.88","-0.2","EURd","SWAP","PROCESSED","2024-04-13 21:06:12","","AMD","Advanced Micro Devices Inc (Extended Hours)","",""
"58823371993359","13620.08","-0.22","EURd","SWAP","PROCESSED","2024-04-13 21:05:49","","TSLA","Tesla Inc (Extended Hours)","",""
"58823371993071","13620.3","-0.22","EURd","SWAP","PROCESSED","2024-04-13 21:05:49","","TSLA","Tesla Inc (Extended Hours)","",""
"58823371992868","13620.52","-0.42","EURd","SWAP","PROCESSED","2024-04-13 21:05:49","","TSLA","Tesla Inc (Extended Hours)","",""
"58823371992787","13620.94","-0.22","EURd","SWAP","PROCESSED","2024-04-13 21:05:49","","TSLA","Tesla Inc (Extended Hours)","",""
"58823371992714","13621.16","-0.42","EURd","SWAP","PROCESSED","2024-04-13 21:05:49","","TSLA","Tesla Inc (Extended Hours)","",""
"58823371992365","13621.58","-0.42","EURd","SWAP","PROCESSED","2024-04-13 21:05:49","","TSLA","Tesla Inc (Extended Hours)","",""
"58823362599583","13622","-0.86","EURd","SWAP","PROCESSED","2024-04-13 21:05:40","","ETH/USD","Ethereum / USD","",""
"58823359446498","13622.86","-0.18","EURd","SWAP","PROCESSED","2024-04-13 21:05:37","","BABA","Alibaba Group Holding Limited (Extended Hours)","",""
"58732844225688","13623.04","-0.93","EURd","SWAP","PROCESSED","2024-04-12 21:06:55","","ETH/USD","Ethereum / USD","",""
"58732828540913","13623.97","-0.18","EURd","SWAP","PROCESSED","2024-04-12 21:06:40","","BABA","Alibaba Group Holding Limited (Extended Hours)","",""
"58732805485487","13624.15","-0.2","EURd","SWAP","PROCESSED","2024-04-12 21:06:18","","AMD","Advanced Micro Devices Inc (Extended Hours)","",""
"58732793924840","13624.35","-0.22","EURd","SWAP","PROCESSED","2024-04-12 21:06:07","","TSLA","Tesla Inc (Extended Hours)","",""
"58732793924479","13624.57","-0.22","EURd","SWAP","PROCESSED","2024-04-12 21:06:07","","TSLA","Tesla Inc (Extended Hours)","",""
"58732793924288","13624.79","-0.42","EURd","SWAP","PROCESSED","2024-04-12 21:06:07","","TSLA","Tesla Inc (Extended Hours)","",""
"58732792875249","13625.21","-0.22","EURd","SWAP","PROCESSED","2024-04-12 21:06:06","","TSLA","Tesla Inc (Extended Hours)","",""
"58732792875188","13625.43","-0.42","EURd","SWAP","PROCESSED","2024-04-12 21:06:06","","TSLA","Tesla Inc (Extended Hours)","",""
"58732792874759","13625.85","-0.42","EURd","SWAP","PROCESSED","2024-04-12 21:06:06","","TSLA","Tesla Inc (Extended Hours)","",""
"58642230540462","13626.27","-1.01","EURd","SWAP","PROCESSED","2024-04-11 21:06:39","","ETH/USD","Ethereum / USD","",""
"58642220037219","13627.28","-0.19","EURd","SWAP","PROCESSED","2024-04-11 21:06:29","","BABA","Alibaba Group Holding Limited (Extended Hours)","",""
"58642187515963","13627.47","-0.21","EURd","SWAP","PROCESSED","2024-04-11 21:05:58","","TSLA","Tesla Inc (Extended Hours)","",""
"58642187515608","13627.68","-0.21","EURd","SWAP","PROCESSED","2024-04-11 21:05:58","","TSLA","Tesla Inc (Extended Hours)","",""
"58642187515428","13627.89","-0.43","EURd","SWAP","PROCESSED","2024-04-11 21:05:58","","TSLA","Tesla Inc (Extended Hours)","",""
"58642187515369","13628.32","-0.21","EURd","SWAP","PROCESSED","2024-04-11 21:05:58","","TSLA","Tesla Inc (Extended Hours)","",""
"58642187515318","13628.53","-0.43","EURd","SWAP","PROCESSED","2024-04-11 21:05:58","","TSLA","Tesla Inc (Extended Hours)","",""
"58642187514944","13628.96","-0.43","EURd","SWAP","PROCESSED","2024-04-11 21:05:58","","TSLA","Tesla Inc (Extended Hours)","",""
"58642168662032","13629.39","-0.21","EURd","SWAP","PROCESSED","2024-04-11 21:05:40","","AMD","Advanced Micro Devices Inc (Extended Hours)","",""
"58551635643329","13629.6","-1.01","EURd","SWAP","PROCESSED","2024-04-10 21:06:41","","ETH/USD","Ethereum / USD","",""
"58551628287472","13630.61","-0.19","EURd","SWAP","PROCESSED","2024-04-10 21:06:34","","BABA","Alibaba Group Holding Limited (Extended Hours)","",""
"58551597871339","13630.8","-0.2","EURd","SWAP","PROCESSED","2024-04-10 21:06:05","","AMD","Advanced Micro Devices Inc (Extended Hours)","",""
"58551549659572","13631","-0.2","EURd","SWAP","PROCESSED","2024-04-10 21:05:19","","TSLA","Tesla Inc (Extended Hours)","",""
"58551549659128","13631.2","-0.2","EURd","SWAP","PROCESSED","2024-04-10 21:05:19","","TSLA","Tesla Inc (Extended Hours)","",""
"58551549658948","13631.4","-0.42","EURd","SWAP","PROCESSED","2024-04-10 21:05:19","","TSLA","Tesla Inc (Extended Hours)","",""
"58551549658893","13631.82","-0.2","EURd","SWAP","PROCESSED","2024-04-10 21:05:19","","TSLA","Tesla Inc (Extended Hours)","",""
"58551549658814","13632.02","-0.42","EURd","SWAP","PROCESSED","2024-04-10 21:05:19","","TSLA","Tesla Inc (Extended Hours)","",""
"58551549658427","13632.44","-0.42","EURd","SWAP","PROCESSED","2024-04-10 21:05:19","","TSLA","Tesla Inc (Extended Hours)","",""
"58461037624107","13632.86","-0.99","EURd","SWAP","PROCESSED","2024-04-09 21:06:40","","ETH/USD","Ethereum / USD","",""
"58461018771065","13633.85","-0.17","EURd","SWAP","PROCESSED","2024-04-09 21:06:22","","BABA","Alibaba Group Holding Limited (Extended Hours)","",""
"58460999854333","13634.02","-0.2","EURd","SWAP","PROCESSED","2024-04-09 21:06:04","","AMD","Advanced Micro Devices Inc (Extended Hours)","",""
"58460941144979","13634.22","-0.21","EURd","SWAP","PROCESSED","2024-04-09 21:05:08","","TSLA","Tesla Inc (Extended Hours)","",""
"58460941144643","13634.43","-0.21","EURd","SWAP","PROCESSED","2024-04-09 21:05:08","","TSLA","Tesla Inc (Extended Hours)","",""
"58460941144472","13634.64","-0.42","EURd","SWAP","PROCESSED","2024-04-09 21:05:08","","TSLA","Tesla Inc (Extended Hours)","",""
"58460941144402","13635.06","-0.21","EURd","SWAP","PROCESSED","2024-04-09 21:05:08","","TSLA","Tesla Inc (Extended Hours)","",""
"58460941144371","13635.27","-0.42","EURd","SWAP","PROCESSED","2024-04-09 21:05:08","","TSLA","Tesla Inc (Extended Hours)","",""
"58460941144015","13635.69","-0.42","EURd","SWAP","PROCESSED","2024-04-09 21:05:08","","TSLA","Tesla Inc (Extended Hours)","",""
"58370441738363","13636.11","-0.17","EURd","SWAP","PROCESSED","2024-04-08 21:06:41","","BABA","Alibaba Group Holding Limited (Extended Hours)","",""
"58370432278101","13636.28","-0.2","EURd","SWAP","PROCESSED","2024-04-08 21:06:32","","AMD","Advanced Micro Devices Inc (Extended Hours)","",""
"58370402915858","13636.48","-1.05","EURd","SWAP","PROCESSED","2024-04-08 21:06:04","","ETH/USD","Ethereum / USD","",""
"58370343152853","13637.53","-0.21","EURd","SWAP","PROCESSED","2024-04-08 21:05:07","","TSLA","Tesla Inc (Extended Hours)","",""
"58370343152484","13637.74","-0.21","EURd","SWAP","PROCESSED","2024-04-08 21:05:07","","TSLA","Tesla Inc (Extended Hours)","",""
"58370343152341","13637.95","-0.41","EURd","SWAP","PROCESSED","2024-04-08 21:05:07","","TSLA","Tesla Inc (Extended Hours)","",""
"58370343152257","13638.36","-0.21","EURd","SWAP","PROCESSED","2024-04-08 21:05:07","","TSLA","Tesla Inc (Extended Hours)","",""
"58370343152199","13638.57","-0.41","EURd","SWAP","PROCESSED","2024-04-08 21:05:07","","TSLA","Tesla Inc (Extended Hours)","",""
"58370343151817","13638.98","-0.41","EURd","SWAP","PROCESSED","2024-04-08 21:05:07","","TSLA","Tesla Inc (Extended Hours)","",""
"58279810130975","13639.39","-0.18","EURd","SWAP","PROCESSED","2024-04-07 21:06:08","","BABA","Alibaba Group Holding Limited (Extended Hours)","",""
"58279796533772","13639.57","-0.2","EURd","SWAP","PROCESSED","2024-04-07 21:05:55","","AMD","Advanced Micro Devices Inc (Extended Hours)","",""
"58279775514438","13639.77","-0.97","EURd","SWAP","PROCESSED","2024-04-07 21:05:35","","ETH/USD","Ethereum / USD","",""
"58279760870268","13640.74","-0.2","EURd","SWAP","PROCESSED","2024-04-07 21:05:21","","TSLA","Tesla Inc (Extended Hours)","",""
"58279760869969","13640.94","-0.2","EURd","SWAP","PROCESSED","2024-04-07 21:05:21","","TSLA","Tesla Inc (Extended Hours)","",""
"58279760869736","13641.14","-0.41","EURd","SWAP","PROCESSED","2024-04-07 21:05:21","","TSLA","Tesla Inc (Extended Hours)","",""
"58279760869705","13641.55","-0.2","EURd","SWAP","PROCESSED","2024-04-07 21:05:21","","TSLA","Tesla Inc (Extended Hours)","",""
"58279760869640","13641.75","-0.41","EURd","SWAP","PROCESSED","2024-04-07 21:05:21","","TSLA","Tesla Inc (Extended Hours)","",""
"58279760869266","13642.16","-0.41","EURd","SWAP","PROCESSED","2024-04-07 21:05:21","","TSLA","Tesla Inc (Extended Hours)","",""
"58189228880088","13642.57","-0.2","EURd","SWAP","PROCESSED","2024-04-06 21:06:23","","AMD","Advanced Micro Devices Inc (Extended Hours)","",""
"58189174360231","13642.77","-0.18","EURd","SWAP","PROCESSED","2024-04-06 21:05:31","","BABA","Alibaba Group Holding Limited (Extended Hours)","",""
"58189163916993","13642.95","-0.96","EURd","SWAP","PROCESSED","2024-04-06 21:05:21","","ETH/USD","Ethereum / USD","",""
"58189155509913","13643.91","-0.2","EURd","SWAP","PROCESSED","2024-04-06 21:05:13","","TSLA","Tesla Inc (Extended Hours)","",""
"58189155509607","13644.11","-0.2","EURd","SWAP","PROCESSED","2024-04-06 21:05:13","","TSLA","Tesla Inc (Extended Hours)","",""
"58189155509412","13644.31","-0.41","EURd","SWAP","PROCESSED","2024-04-06 21:05:13","","TSLA","Tesla Inc (Extended Hours)","",""
"58189155509373","13644.72","-0.2","EURd","SWAP","PROCESSED","2024-04-06 21:05:13","","TSLA","Tesla Inc (Extended Hours)","",""
"58189155509314","13644.92","-0.41","EURd","SWAP","PROCESSED","2024-04-06 21:05:13","","TSLA","Tesla Inc (Extended Hours)","",""
"58189155508936","13645.33","-0.41","EURd","SWAP","PROCESSED","2024-04-06 21:05:13","","TSLA","Tesla Inc (Extended Hours)","",""
"58098634033343","13645.74","-0.2","EURd","SWAP","PROCESSED","2024-04-05 21:06:25","","AMD","Advanced Micro Devices Inc (Extended Hours)","",""
"58098576367058","13645.94","-0.95","EURd","SWAP","PROCESSED","2024-04-05 21:05:30","","ETH/USD","Ethereum / USD","",""
"58098565857982","13646.89","-0.18","EURd","SWAP","PROCESSED","2024-04-05 21:05:20","","BABA","Alibaba Group Holding Limited (Extended Hours)","",""
"58098560604526","13647.07","-0.2","EURd","SWAP","PROCESSED","2024-04-05 21:05:15","","TSLA","Tesla Inc (Extended Hours)","",""
"58098560604255","13647.27","-0.2","EURd","SWAP","PROCESSED","2024-04-05 21:05:15","","TSLA","Tesla Inc (Extended Hours)","",""
"58098560604076","13647.47","-0.41","EURd","SWAP","PROCESSED","2024-04-05 21:05:15","","TSLA","Tesla Inc (Extended Hours)","",""
"58098560604033","13647.88","-0.2","EURd","SWAP","PROCESSED","2024-04-05 21:05:15","","TSLA","Tesla Inc (Extended Hours)","",""
"58098560603965","13648.08","-0.41","EURd","SWAP","PROCESSED","2024-04-05 21:05:15","","TSLA","Tesla Inc (Extended Hours)","",""
"58098560603453","13648.49","-0.41","EURd","SWAP","PROCESSED","2024-04-05 21:05:15","","TSLA","Tesla Inc (Extended Hours)","",""
"58008027612502","13648.9","-0.2","EURd","SWAP","PROCESSED","2024-04-04 21:06:16","","AMD","Advanced Micro Devices Inc (Extended Hours)","",""
"58008014016217","13649.1","-0.95","EURd","SWAP","PROCESSED","2024-04-04 21:06:03","","ETH/USD","Ethereum / USD","",""
"58008004560470","13650.05","-0.18","EURd","SWAP","PROCESSED","2024-04-04 21:05:54","","BABA","Alibaba Group Holding Limited (Extended Hours)","",""
"58007990902609","13650.23","-0.2","EURd","SWAP","PROCESSED","2024-04-04 21:05:41","","TSLA","Tesla Inc (Extended Hours)","",""
"58007990902267","13650.43","-0.2","EURd","SWAP","PROCESSED","2024-04-04 21:05:41","","TSLA","Tesla Inc (Extended Hours)","",""
"58007990902043","13650.63","-0.42","EURd","SWAP","PROCESSED","2024-04-04 21:05:41","","TSLA","Tesla Inc (Extended Hours)","",""
"58007990902008","13651.05","-0.2","EURd","SWAP","PROCESSED","2024-04-04 21:05:41","","TSLA","Tesla Inc (Extended Hours)","",""
"58007990901929","13651.25","-0.42","EURd","SWAP","PROCESSED","2024-04-04 21:05:41","","TSLA","Tesla Inc (Extended Hours)","",""
"58007989852877","13651.67","-0.42","EURd","SWAP","PROCESSED","2024-04-04 21:05:40","","TSLA","Tesla Inc (Extended Hours)","",""
"57917441164919","13652.09","-0.2","EURd","SWAP","PROCESSED","2024-04-03 21:06:26","","TSLA","Tesla Inc (Extended Hours)","",""
"57917441164592","13652.29","-0.2","EURd","SWAP","PROCESSED","2024-04-03 21:06:26","","TSLA","Tesla Inc (Extended Hours)","",""
"57917441164404","13652.49","-0.41","EURd","SWAP","PROCESSED","2024-04-03 21:06:26","","TSLA","Tesla Inc (Extended Hours)","",""
"57917441164355","13652.9","-0.2","EURd","SWAP","PROCESSED","2024-04-03 21:06:26","","TSLA","Tesla Inc (Extended Hours)","",""
"57917441164301","13653.1","-0.41","EURd","SWAP","PROCESSED","2024-04-03 21:06:26","","TSLA","Tesla Inc (Extended Hours)","",""
"57917441163767","13653.51","-0.41","EURd","SWAP","PROCESSED","2024-04-03 21:06:26","","TSLA","Tesla Inc (Extended Hours)","",""
"57917423297631","13653.92","-0.22","EURd","SWAP","PROCESSED","2024-04-03 21:06:09","","AMD","Advanced Micro Devices Inc (Extended Hours)","",""
"57917377193627","13654.14","-0.94","EURd","SWAP","PROCESSED","2024-04-03 21:05:25","","ETH/USD","Ethereum / USD","",""
"57917356179993","13655.08","-0.18","EURd","SWAP","PROCESSED","2024-04-03 21:05:05","","BABA","Alibaba Group Holding Limited (Extended Hours)","",""
"57826831622960","13655.26","-0.2","EURd","SWAP","PROCESSED","2024-04-02 21:06:14","","TSLA","Tesla Inc (Extended Hours)","",""
"57826830574040","13655.46","-0.2","EURd","SWAP","PROCESSED","2024-04-02 21:06:13","","TSLA","Tesla Inc (Extended Hours)","",""
"57826830573869","13655.66","-0.41","EURd","SWAP","PROCESSED","2024-04-02 21:06:13","","TSLA","Tesla Inc (Extended Hours)","",""
"57826830573819","13656.07","-0.2","EURd","SWAP","PROCESSED","2024-04-02 21:06:13","","TSLA","Tesla Inc (Extended Hours)","",""
"57826830573738","13656.27","-0.41","EURd","SWAP","PROCESSED","2024-04-02 21:06:13","","TSLA","Tesla Inc (Extended Hours)","",""
"57826830573355","13656.68","-0.41","EURd","SWAP","PROCESSED","2024-04-02 21:06:13","","TSLA","Tesla Inc (Extended Hours)","",""
"57826813752871","13657.09","-0.21","EURd","SWAP","PROCESSED","2024-04-02 21:05:57","","AMD","Advanced Micro Devices Inc (Extended Hours)","",""
"57826774991108","13657.3","-0.94","EURd","SWAP","PROCESSED","2024-04-02 21:05:20","","ETH/USD","Ethereum / USD","",""
"57826760273971","13658.24","-0.18","EURd","SWAP","PROCESSED","2024-04-02 21:05:06","","BABA","Alibaba Group Holding Limited (Extended Hours)","",""
"57736257680379","13658.42","-0.22","EURd","SWAP","PROCESSED","2024-04-01 21:06:36","","AMD","Advanced Micro Devices Inc (Extended Hours)","",""
"57736210507652","13658.64","-0.21","EURd","SWAP","PROCESSED","2024-04-01 21:05:51","","TSLA","Tesla Inc (Extended Hours)","",""
"57736210507346","13658.85","-0.21","EURd","SWAP","PROCESSED","2024-04-01 21:05:51","","TSLA","Tesla Inc (Extended Hours)","",""
"57736210507205","13659.06","-0.43","EURd","SWAP","PROCESSED","2024-04-01 21:05:51","","TSLA","Tesla Inc (Extended Hours)","",""
"57736210507156","13659.49","-0.21","EURd","SWAP","PROCESSED","2024-04-01 21:05:51","","TSLA","Tesla Inc (Extended Hours)","",""
"57736210507062","13659.7","-0.43","EURd","SWAP","PROCESSED","2024-04-01 21:05:51","","TSLA","Tesla Inc (Extended Hours)","",""
"57736209458156","13660.13","-0.43","EURd","SWAP","PROCESSED","2024-04-01 21:05:50","","TSLA","Tesla Inc (Extended Hours)","",""
"57736203150731","13660.56","-1","EURd","SWAP","PROCESSED","2024-04-01 21:05:44","","ETH/USD","Ethereum / USD","",""
"57736167538063","13661.56","-0.18","EURd","SWAP","PROCESSED","2024-04-01 21:05:10","","BABA","Alibaba Group Holding Limited (Extended Hours)","",""
"57645670144179","13661.74","-0.22","EURd","SWAP","PROCESSED","2024-03-31 21:06:45","","AMD","Advanced Micro Devices Inc (Extended Hours)","",""
"57645663909302","13661.96","-0.21","EURd","SWAP","PROCESSED","2024-03-31 21:06:39","","TSLA","Tesla Inc (Extended Hours)","",""
"57645663909110","13662.17","-0.21","EURd","SWAP","PROCESSED","2024-03-31 21:06:39","","TSLA","Tesla Inc (Extended Hours)","",""
"57645663908991","13662.38","-0.43","EURd","SWAP","PROCESSED","2024-03-31 21:06:39","","TSLA","Tesla Inc (Extended Hours)","",""
"57645663908950","13662.81","-0.21","EURd","SWAP","PROCESSED","2024-03-31 21:06:39","","TSLA","Tesla Inc (Extended Hours)","",""
"57645663908910","13663.02","-0.43","EURd","SWAP","PROCESSED","2024-03-31 21:06:39","","TSLA","Tesla Inc (Extended Hours)","",""
"57645663908662","13663.45","-0.43","EURd","SWAP","PROCESSED","2024-03-31 21:06:39","","TSLA","Tesla Inc (Extended Hours)","",""
"57645640782743","13663.88","-1.04","EURd","SWAP","PROCESSED","2024-03-31 21:06:17","","ETH/USD","Ethereum / USD","",""
"57645587313587","13664.92","-0.18","EURd","SWAP","PROCESSED","2024-03-31 21:05:26","","BABA","Alibaba Group Holding Limited (Extended Hours)","",""
"57555071138349","13665.1","-0.22","EURd","SWAP","PROCESSED","2024-03-30 21:06:43","","AMD","Advanced Micro Devices Inc (Extended Hours)","",""
"57555067988978","13665.32","-1","EURd","SWAP","PROCESSED","2024-03-30 21:06:40","","ETH/USD","Ethereum / USD","",""
"57555062738958","13666.32","-0.21","EURd","SWAP","PROCESSED","2024-03-30 21:06:35","","TSLA","Tesla Inc (Extended Hours)","",""
"57555062738769","13666.53","-0.21","EURd","SWAP","PROCESSED","2024-03-30 21:06:35","","TSLA","Tesla Inc (Extended Hours)","",""
"57555062738656","13666.74","-0.43","EURd","SWAP","PROCESSED","2024-03-30 21:06:35","","TSLA","Tesla Inc (Extended Hours)","",""
"57555062738624","13667.17","-0.21","EURd","SWAP","PROCESSED","2024-03-30 21:06:35","","TSLA","Tesla Inc (Extended Hours)","",""
"57555062738584","13667.38","-0.43","EURd","SWAP","PROCESSED","2024-03-30 21:06:35","","TSLA","Tesla Inc (Extended Hours)","",""
"57555062738353","13667.81","-0.43","EURd","SWAP","PROCESSED","2024-03-30 21:06:35","","TSLA","Tesla Inc (Extended Hours)","",""
"57555014513210","13668.24","-0.18","EURd","SWAP","PROCESSED","2024-03-30 21:05:49","","BABA","Alibaba Group Holding Limited (Extended Hours)","",""
"57464448924509","13668.42","-0.21","EURd","SWAP","PROCESSED","2024-03-29 21:06:19","","TSLA","Tesla Inc (Extended Hours)","",""
"57464448924355","13668.63","-0.43","EURd","SWAP","PROCESSED","2024-03-29 21:06:19","","TSLA","Tesla Inc (Extended Hours)","",""
"57464448924279","13669.06","-0.21","EURd","SWAP","PROCESSED","2024-03-29 21:06:19","","TSLA","Tesla Inc (Extended Hours)","",""
"57464448924218","13669.27","-0.43","EURd","SWAP","PROCESSED","2024-03-29 21:06:19","","TSLA","Tesla Inc (Extended Hours)","",""
"57464447865220","13669.7","-0.22","EURd","SWAP","PROCESSED","2024-03-29 21:06:18","","AMD","Advanced Micro Devices Inc (Extended Hours)","",""
"57464393322784","13669.92","-0.18","EURd","SWAP","PROCESSED","2024-03-29 21:05:26","","BABA","Alibaba Group Holding Limited (Extended Hours)","",""
"57373848781138","13670.1","-0.21","EURd","SWAP","PROCESSED","2024-03-28 21:06:16","","TSLA","Tesla Inc (Extended Hours)","",""
"57283300061137","13670.31","-0.21","EURd","SWAP","PROCESSED","2024-03-27 21:07:02","","AMD","Advanced Micro Devices Inc (Extended Hours)","",""
"57283292711186","13670.52","-0.21","EURd","SWAP","PROCESSED","2024-03-27 21:06:55","","TSLA","Tesla Inc (Extended Hours)","",""
"57283292710967","13670.73","-0.21","EURd","SWAP","PROCESSED","2024-03-27 21:06:55","","TSLA","Tesla Inc (Extended Hours)","",""
"57283292710852","13670.94","-0.43","EURd","SWAP","PROCESSED","2024-03-27 21:06:55","","TSLA","Tesla Inc (Extended Hours)","",""
"57283292710812","13671.37","-0.21","EURd","SWAP","PROCESSED","2024-03-27 21:06:55","","TSLA","Tesla Inc (Extended Hours)","",""
"57283292710783","13671.58","-0.43","EURd","SWAP","PROCESSED","2024-03-27 21:06:55","","TSLA","Tesla Inc (Extended Hours)","",""
"57283292710576","13672.01","-0.43","EURd","SWAP","PROCESSED","2024-03-27 21:06:55","","TSLA","Tesla Inc (Extended Hours)","",""
"57283272794856","13672.44","-1","EURd","SWAP","PROCESSED","2024-03-27 21:06:36","","ETH/USD","Ethereum / USD","",""
"57283207785904","13673.44","-0.18","EURd","SWAP","PROCESSED","2024-03-27 21:05:34","","BABA","Alibaba Group Holding Limited (Extended Hours)","",""
"57192676869400","13673.62","-0.18","EURd","SWAP","PROCESSED","2024-03-26 21:06:37","","BABA","Alibaba Group Holding Limited (Extended Hours)","",""
"57192662202857","13673.8","-0.21","EURd","SWAP","PROCESSED","2024-03-26 21:06:23","","AMD","Advanced Micro Devices Inc (Extended Hours)","",""
"57192651708728","13674.01","-0.21","EURd","SWAP","PROCESSED","2024-03-26 21:06:13","","TSLA","Tesla Inc (Extended Hours)","",""
"57192651708232","13674.22","-0.21","EURd","SWAP","PROCESSED","2024-03-26 21:06:13","","TSLA","Tesla Inc (Extended Hours)","",""
"57192651708022","13674.43","-0.43","EURd","SWAP","PROCESSED","2024-03-26 21:06:13","","TSLA","Tesla Inc (Extended Hours)","",""
"57192651707966","13674.86","-0.21","EURd","SWAP","PROCESSED","2024-03-26 21:06:13","","TSLA","Tesla Inc (Extended Hours)","",""
"57192651707898","13675.07","-0.43","EURd","SWAP","PROCESSED","2024-03-26 21:06:13","","TSLA","Tesla Inc (Extended Hours)","",""
"57192651707540","13675.5","-0.43","EURd","SWAP","PROCESSED","2024-03-26 21:06:13","","TSLA","Tesla Inc (Extended Hours)","",""
"57192637026422","13675.93","-1.02","EURd","SWAP","PROCESSED","2024-03-26 21:05:59","","ETH/USD","Ethereum / USD","",""
"57102108217565","13676.95","-0.21","EURd","SWAP","PROCESSED","2024-03-25 21:07:04","","AMD","Advanced Micro Devices Inc (Extended Hours)","",""
"57102072564569","13677.16","-0.21","EURd","SWAP","PROCESSED","2024-03-25 21:06:30","","TSLA","Tesla Inc (Extended Hours)","",""
"57102072563885","13677.37","-0.21","EURd","SWAP","PROCESSED","2024-03-25 21:06:30","","TSLA","Tesla Inc (Extended Hours)","",""
"57102072563621","13677.58","-0.42","EURd","SWAP","PROCESSED","2024-03-25 21:06:30","","TSLA","Tesla Inc (Extended Hours)","",""
"57102072563523","13678","-0.21","EURd","SWAP","PROCESSED","2024-03-25 21:06:30","","TSLA","Tesla Inc (Extended Hours)","",""
"57102072563459","13678.21","-0.42","EURd","SWAP","PROCESSED","2024-03-25 21:06:30","","TSLA","Tesla Inc (Extended Hours)","",""
"57102071514547","13678.63","-0.42","EURd","SWAP","PROCESSED","2024-03-25 21:06:29","","TSLA","Tesla Inc (Extended Hours)","",""
"57102045299123","13679.05","-1.03","EURd","SWAP","PROCESSED","2024-03-25 21:06:04","","ETH/USD","Ethereum / USD","",""
"57101998119999","13680.08","-0.18","EURd","SWAP","PROCESSED","2024-03-25 21:05:19","","BABA","Alibaba Group Holding Limited (Extended Hours)","",""
"57011506016585","13680.26","-0.21","EURd","SWAP","PROCESSED","2024-03-24 21:06:59","","AMD","Advanced Micro Devices Inc (Extended Hours)","",""
"57011497616097","13680.47","-0.2","EURd","SWAP","PROCESSED","2024-03-24 21:06:51","","TSLA","Tesla Inc (Extended Hours)","",""
"57011497615910","13680.67","-0.2","EURd","SWAP","PROCESSED","2024-03-24 21:06:51","","TSLA","Tesla Inc (Extended Hours)","",""
"57011497615787","13680.87","-0.42","EURd","SWAP","PROCESSED","2024-03-24 21:06:51","","TSLA","Tesla Inc (Extended Hours)","",""
"57011497615754","13681.29","-0.2","EURd","SWAP","PROCESSED","2024-03-24 21:06:51","","TSLA","Tesla Inc (Extended Hours)","",""
"57011497615718","13681.49","-0.42","EURd","SWAP","PROCESSED","2024-03-24 21:06:51","","TSLA","Tesla Inc (Extended Hours)","",""
"57011497615505","13681.91","-0.42","EURd","SWAP","PROCESSED","2024-03-24 21:06:51","","TSLA","Tesla Inc (Extended Hours)","",""
"57011463020799","13682.33","-0.97","EURd","SWAP","PROCESSED","2024-03-24 21:06:18","","ETH/USD","Ethereum / USD","",""
"57011430516698","13683.3","-0.18","EURd","SWAP","PROCESSED","2024-03-24 21:05:47","","BABA","Alibaba Group Holding Limited (Extended Hours)","",""
"56920898560516","13683.48","-0.96","EURd","SWAP","PROCESSED","2024-03-23 21:06:49","","ETH/USD","Ethereum / USD","",""
"56920876544288","13684.44","-0.18","EURd","SWAP","PROCESSED","2024-03-23 21:06:28","","BABA","Alibaba Group Holding Limited (Extended Hours)","",""
"56920872340356","13684.62","-0.21","EURd","SWAP","PROCESSED","2024-03-23 21:06:24","","AMD","Advanced Micro Devices Inc (Extended Hours)","",""
"56920844036054","13684.83","-0.2","EURd","SWAP","PROCESSED","2024-03-23 21:05:57","","TSLA","Tesla Inc (Extended Hours)","",""
"56920842987093","13685.03","-0.2","EURd","SWAP","PROCESSED","2024-03-23 21:05:56","","TSLA","Tesla Inc (Extended Hours)","",""
"56920842986887","13685.23","-0.42","EURd","SWAP","PROCESSED","2024-03-23 21:05:56","","TSLA","Tesla Inc (Extended Hours)","",""
"56920842986821","13685.65","-0.2","EURd","SWAP","PROCESSED","2024-03-23 21:05:56","","TSLA","Tesla Inc (Extended Hours)","",""
"56920842986766","13685.85","-0.42","EURd","SWAP","PROCESSED","2024-03-23 21:05:56","","TSLA","Tesla Inc (Extended Hours)","",""
"56920842986359","13686.27","-0.42","EURd","SWAP","PROCESSED","2024-03-23 21:05:56","","TSLA","Tesla Inc (Extended Hours)","",""
"56830305780632","13686.69","-0.21","EURd","SWAP","PROCESSED","2024-03-22 21:06:53","","AMD","Advanced Micro Devices Inc (Extended Hours)","",""
"56830290053027","13686.9","-0.2","EURd","SWAP","PROCESSED","2024-03-22 21:06:38","","TSLA","Tesla Inc (Extended Hours)","",""
"56830289004022","13687.1","-0.2","EURd","SWAP","PROCESSED","2024-03-22 21:06:37","","TSLA","Tesla Inc (Extended Hours)","",""
"56830289003829","13687.3","-0.42","EURd","SWAP","PROCESSED","2024-03-22 21:06:37","","TSLA","Tesla Inc (Extended Hours)","",""
"56830289003761","13687.72","-0.2","EURd","SWAP","PROCESSED","2024-03-22 21:06:37","","TSLA","Tesla Inc (Extended Hours)","",""
"56830289003697","13687.92","-0.42","EURd","SWAP","PROCESSED","2024-03-22 21:06:37","","TSLA","Tesla Inc (Extended Hours)","",""
"56830289003226","13688.34","-0.42","EURd","SWAP","PROCESSED","2024-03-22 21:06:37","","TSLA","Tesla Inc (Extended Hours)","",""
"56830284816468","13688.76","-0.94","EURd","SWAP","PROCESSED","2024-03-22 21:06:33","","ETH/USD","Ethereum / USD","",""
"56830227145524","13689.7","-0.18","EURd","SWAP","PROCESSED","2024-03-22 21:05:38","","BABA","Alibaba Group Holding Limited (Extended Hours)","",""
"56739686801792","13689.88","-0.21","EURd","SWAP","PROCESSED","2024-03-21 21:06:32","","AMD","Advanced Micro Devices Inc (Extended Hours)","",""
"56739660591849","13690.09","-0.21","EURd","SWAP","PROCESSED","2024-03-21 21:06:07","","TSLA","Tesla Inc (Extended Hours)","",""
"56739660591429","13690.3","-0.21","EURd","SWAP","PROCESSED","2024-03-21 21:06:07","","TSLA","Tesla Inc (Extended Hours)","",""
"56739660591234","13690.51","-0.41","EURd","SWAP","PROCESSED","2024-03-21 21:06:07","","TSLA","Tesla Inc (Extended Hours)","",""
"56739660591182","13690.92","-0.21","EURd","SWAP","PROCESSED","2024-03-21 21:06:07","","TSLA","Tesla Inc (Extended Hours)","",""
"56739660591141","13691.13","-0.41","EURd","SWAP","PROCESSED","2024-03-21 21:06:07","","TSLA","Tesla Inc (Extended Hours)","",""
"56739660590772","13691.54","-0.41","EURd","SWAP","PROCESSED","2024-03-21 21:06:07","","TSLA","Tesla Inc (Extended Hours)","",""
"56739645911708","13691.95","-0.99","EURd","SWAP","PROCESSED","2024-03-21 21:05:53","","ETH/USD","Ethereum / USD","",""
"56739611296886","13692.94","-0.17","EURd","SWAP","PROCESSED","2024-03-21 21:05:20","","BABA","Alibaba Group Holding Limited (Extended Hours)","",""
"56649084591881","13693.11","-0.22","EURd","SWAP","PROCESSED","2024-03-20 21:06:27","","AMD","Advanced Micro Devices Inc (Extended Hours)","",""
"56649075162384","13693.33","-0.21","EURd","SWAP","PROCESSED","2024-03-20 21:06:18","","TSLA","Tesla Inc (Extended Hours)","",""
"56649074113368","13693.54","-0.21","EURd","SWAP","PROCESSED","2024-03-20 21:06:17","","TSLA","Tesla Inc (Extended Hours)","",""
"56649074113198","13693.75","-0.42","EURd","SWAP","PROCESSED","2024-03-20 21:06:17","","TSLA","Tesla Inc (Extended Hours)","",""
"56649074113139","13694.17","-0.21","EURd","SWAP","PROCESSED","2024-03-20 21:06:17","","TSLA","Tesla Inc (Extended Hours)","",""
"56649074113101","13694.38","-0.42","EURd","SWAP","PROCESSED","2024-03-20 21:06:17","","TSLA","Tesla Inc (Extended Hours)","",""
"56649074112715","13694.8","-0.42","EURd","SWAP","PROCESSED","2024-03-20 21:06:17","","TSLA","Tesla Inc (Extended Hours)","",""
"56649044738963","13695.22","-0.17","EURd","SWAP","PROCESSED","2024-03-20 21:05:49","","BABA","Alibaba Group Holding Limited (Extended Hours)","",""
"56649001750772","13695.39","-0.98","EURd","SWAP","PROCESSED","2024-03-20 21:05:08","","ETH/USD","Ethereum / USD","",""
"56558492873077","13696.37","-0.22","EURd","SWAP","PROCESSED","2024-03-19 21:06:32","","AMD","Advanced Micro Devices Inc (Extended Hours)","",""
"56558469797430","13696.59","-0.2","EURd","SWAP","PROCESSED","2024-03-19 21:06:10","","TSLA","Tesla Inc (Extended Hours)","",""
"56558469797054","13696.79","-0.2","EURd","SWAP","PROCESSED","2024-03-19 21:06:10","","TSLA","Tesla Inc (Extended Hours)","",""
"56558469796906","13696.99","-0.41","EURd","SWAP","PROCESSED","2024-03-19 21:06:10","","TSLA","Tesla Inc (Extended Hours)","",""
"56558468745817","13697.4","-0.2","EURd","SWAP","PROCESSED","2024-03-19 21:06:09","","TSLA","Tesla Inc (Extended Hours)","",""
"56558468745741","13697.6","-0.41","EURd","SWAP","PROCESSED","2024-03-19 21:06:09","","TSLA","Tesla Inc (Extended Hours)","",""
"56558467696749","13698.01","-0.41","EURd","SWAP","PROCESSED","2024-03-19 21:06:08","","TSLA","Tesla Inc (Extended Hours)","",""
"56558450931600","13698.42","-0.17","EURd","SWAP","PROCESSED","2024-03-19 21:05:52","","BABA","Alibaba Group Holding Limited (Extended Hours)","",""
"56558410026130","13698.59","-0.93","EURd","SWAP","PROCESSED","2024-03-19 21:05:13","","ETH/USD","Ethereum / USD","",""
"56467897993236","13699.52","-0.23","EURd","SWAP","PROCESSED","2024-03-18 21:06:34","","AMD","Advanced Micro Devices Inc (Extended Hours)","",""
"56467881228020","13699.75","-0.21","EURd","SWAP","PROCESSED","2024-03-18 21:06:18","","TSLA","Tesla Inc (Extended Hours)","",""
"56467881227026","13699.96","-0.21","EURd","SWAP","PROCESSED","2024-03-18 21:06:18","","TSLA","Tesla Inc (Extended Hours)","",""
"56467881226838","13700.17","-0.42","EURd","SWAP","PROCESSED","2024-03-18 21:06:18","","TSLA","Tesla Inc (Extended Hours)","",""
"56467881226763","13700.59","-0.21","EURd","SWAP","PROCESSED","2024-03-18 21:06:18","","TSLA","Tesla Inc (Extended Hours)","",""
"56467881226713","13700.8","-0.42","EURd","SWAP","PROCESSED","2024-03-18 21:06:18","","TSLA","Tesla Inc (Extended Hours)","",""
"56467880177776","13701.22","-0.42","EURd","SWAP","PROCESSED","2024-03-18 21:06:17","","TSLA","Tesla Inc (Extended Hours)","",""
"56467851856237","13701.64","-0.17","EURd","SWAP","PROCESSED","2024-03-18 21:05:50","","BABA","Alibaba Group Holding Limited (Extended Hours)","",""
"56467812008737","13701.81","-0.99","EURd","SWAP","PROCESSED","2024-03-18 21:05:11","","ETH/USD","Ethereum / USD","",""
"56439352614528","13702.8","85.15","EURd","TRADE","PROCESSED","2024-03-18 13:32:51","073cf1cc-0055-311e-0000-4d580004313d_073cf1cc-0055-311e-0000-000080310018","GOOGL","Alphabet Inc - A (Extended Hours)","",""
"56439351565948","13617.65","15.16","EURd","TRADE","PROCESSED","2024-03-18 13:32:50","073cf1cc-0055-311e-0000-4d580004313b_073cf1cc-0055-311e-0000-0000802e0084","GOOGL","Alphabet Inc - A (Extended Hours)","",""
"56377273777424","13602.49","-0.34","EURd","SWAP","PROCESSED","2024-03-17 21:06:08","","GOOGL","Alphabet Inc - A (Extended Hours)","",""
"56377273777316","13602.83","-0.34","EURd","SWAP","PROCESSED","2024-03-17 21:06:08","","GOOGL","Alphabet Inc - A (Extended Hours)","",""
"56377267470753","13603.17","-0.19","EURd","SWAP","PROCESSED","2024-03-17 21:06:02","","TSLA","Tesla Inc (Extended Hours)","",""
"56377266421811","13603.36","-0.19","EURd","SWAP","PROCESSED","2024-03-17 21:06:01","","TSLA","Tesla Inc (Extended Hours)","",""
"56377266438003","13603.55","-0.39","EURd","SWAP","PROCESSED","2024-03-17 21:06:01","","TSLA","Tesla Inc (Extended Hours)","",""
"56377266437939","13603.94","-0.19","EURd","SWAP","PROCESSED","2024-03-17 21:06:01","","TSLA","Tesla Inc (Extended Hours)","",""
"56377266437880","13604.13","-0.39","EURd","SWAP","PROCESSED","2024-03-17 21:06:01","","TSLA","Tesla Inc (Extended Hours)","",""
"56377266437578","13604.52","-0.39","EURd","SWAP","PROCESSED","2024-03-17 21:06:01","","TSLA","Tesla Inc (Extended Hours)","",""
"56286657937184","13604.91","-0.19","EURd","SWAP","PROCESSED","2024-03-16 21:05:50","","TSLA","Tesla Inc (Extended Hours)","",""
"56286657936841","13605.1","-0.19","EURd","SWAP","PROCESSED","2024-03-16 21:05:50","","TSLA","Tesla Inc (Extended Hours)","",""
"56286657936608","13605.29","-0.39","EURd","SWAP","PROCESSED","2024-03-16 21:05:50","","TSLA","Tesla Inc (Extended Hours)","",""
"56286656885170","13605.68","-0.19","EURd","SWAP","PROCESSED","2024-03-16 21:05:49","","TSLA","Tesla Inc (Extended Hours)","",""
"56286656885117","13605.87","-0.39","EURd","SWAP","PROCESSED","2024-03-16 21:05:49","","TSLA","Tesla Inc (Extended Hours)","",""
"56286656884743","13606.26","-0.39","EURd","SWAP","PROCESSED","2024-03-16 21:05:49","","TSLA","Tesla Inc (Extended Hours)","",""
"56286645344661","13606.65","-0.34","EURd","SWAP","PROCESSED","2024-03-16 21:05:38","","GOOGL","Alphabet Inc - A (Extended Hours)","",""
"56286645344501","13606.99","-0.34","EURd","SWAP","PROCESSED","2024-03-16 21:05:38","","GOOGL","Alphabet Inc - A (Extended Hours)","",""
"56196070395326","13607.33","-0.34","EURd","SWAP","PROCESSED","2024-03-15 21:05:59","","GOOGL","Alphabet Inc - A (Extended Hours)","",""
"56196070395238","13607.67","-0.34","EURd","SWAP","PROCESSED","2024-03-15 21:05:59","","GOOGL","Alphabet Inc - A (Extended Hours)","",""
"56196064107257","13608.01","-0.19","EURd","SWAP","PROCESSED","2024-03-15 21:05:53","","TSLA","Tesla Inc (Extended Hours)","",""
"56196064106772","13608.2","-0.19","EURd","SWAP","PROCESSED","2024-03-15 21:05:53","","TSLA","Tesla Inc (Extended Hours)","",""
"56196064106616","13608.39","-0.39","EURd","SWAP","PROCESSED","2024-03-15 21:05:53","","TSLA","Tesla Inc (Extended Hours)","",""
"56196064106547","13608.78","-0.19","EURd","SWAP","PROCESSED","2024-03-15 21:05:53","","TSLA","Tesla Inc (Extended Hours)","",""
"56196064106509","13608.97","-0.39","EURd","SWAP","PROCESSED","2024-03-15 21:05:53","","TSLA","Tesla Inc (Extended Hours)","",""
"56196063057473","13609.36","-0.39","EURd","SWAP","PROCESSED","2024-03-15 21:05:52","","TSLA","Tesla Inc (Extended Hours)","",""
"56105493360129","13609.75","-0.19","EURd","SWAP","PROCESSED","2024-03-14 21:06:18","","TSLA","Tesla Inc (Extended Hours)","",""
"56105493359701","13609.94","-0.19","EURd","SWAP","PROCESSED","2024-03-14 21:06:18","","TSLA","Tesla Inc (Extended Hours)","",""
"56105493359485","13610.13","-0.39","EURd","SWAP","PROCESSED","2024-03-14 21:06:18","","TSLA","Tesla Inc (Extended Hours)","",""
"56105493359434","13610.52","-0.19","EURd","SWAP","PROCESSED","2024-03-14 21:06:18","","TSLA","Tesla Inc (Extended Hours)","",""
"56105493359381","13610.71","-0.39","EURd","SWAP","PROCESSED","2024-03-14 21:06:18","","TSLA","Tesla Inc (Extended Hours)","",""
"56105493359003","13611.1","-0.39","EURd","SWAP","PROCESSED","2024-03-14 21:06:18","","TSLA","Tesla Inc (Extended Hours)","",""
"56105486020811","13611.49","-0.35","EURd","SWAP","PROCESSED","2024-03-14 21:06:11","","GOOGL","Alphabet Inc - A (Extended Hours)","",""
"56105486020575","13611.84","-0.35","EURd","SWAP","PROCESSED","2024-03-14 21:06:11","","GOOGL","Alphabet Inc - A (Extended Hours)","",""
"56014896382434","13612.19","-0.34","EURd","SWAP","PROCESSED","2024-03-13 21:06:18","","GOOGL","Alphabet Inc - A (Extended Hours)","",""
"56014896382338","13612.53","-0.34","EURd","SWAP","PROCESSED","2024-03-13 21:06:18","","GOOGL","Alphabet Inc - A (Extended Hours)","",""
"56014877515697","13612.87","-0.2","EURd","SWAP","PROCESSED","2024-03-13 21:06:00","","TSLA","Tesla Inc (Extended Hours)","",""
"56014877515333","13613.07","-0.2","EURd","SWAP","PROCESSED","2024-03-13 21:06:00","","TSLA","Tesla Inc (Extended Hours)","",""
"56014877515141","13613.27","-0.4","EURd","SWAP","PROCESSED","2024-03-13 21:06:00","","TSLA","Tesla Inc (Extended Hours)","",""
"56014877515040","13613.67","-0.2","EURd","SWAP","PROCESSED","2024-03-13 21:06:00","","TSLA","Tesla Inc (Extended Hours)","",""
"56014877514974","13613.87","-0.4","EURd","SWAP","PROCESSED","2024-03-13 21:06:00","","TSLA","Tesla Inc (Extended Hours)","",""
"56014876466093","13614.27","-0.4","EURd","SWAP","PROCESSED","2024-03-13 21:05:59","","TSLA","Tesla Inc (Extended Hours)","",""
"55924272152691","13614.67","-0.33","EURd","SWAP","PROCESSED","2024-03-12 21:05:52","","GOOGL","Alphabet Inc - A (Extended Hours)","",""
"55924272152581","13615","-0.33","EURd","SWAP","PROCESSED","2024-03-12 21:05:52","","GOOGL","Alphabet Inc - A (Extended Hours)","",""
"55924258522894","13615.33","-0.21","EURd","SWAP","PROCESSED","2024-03-12 21:05:39","","TSLA","Tesla Inc (Extended Hours)","",""
"55924258522405","13615.54","-0.21","EURd","SWAP","PROCESSED","2024-03-12 21:05:39","","TSLA","Tesla Inc (Extended Hours)","",""
"55924258522161","13615.75","-0.42","EURd","SWAP","PROCESSED","2024-03-12 21:05:39","","TSLA","Tesla Inc (Extended Hours)","",""
"55924258522006","13616.17","-0.21","EURd","SWAP","PROCESSED","2024-03-12 21:05:39","","TSLA","Tesla Inc (Extended Hours)","",""
"55924258521948","13616.38","-0.42","EURd","SWAP","PROCESSED","2024-03-12 21:05:39","","TSLA","Tesla Inc (Extended Hours)","",""
"55924258521509","13616.8","-0.42","EURd","SWAP","PROCESSED","2024-03-12 21:05:39","","TSLA","Tesla Inc (Extended Hours)","",""
"55833679390843","13617.22","-0.33","EURd","SWAP","PROCESSED","2024-03-11 21:05:56","","GOOGL","Alphabet Inc - A (Extended Hours)","",""
"55833679390643","13617.55","-0.33","EURd","SWAP","PROCESSED","2024-03-11 21:05:56","","GOOGL","Alphabet Inc - A (Extended Hours)","",""
"55833667861743","13617.88","-0.21","EURd","SWAP","PROCESSED","2024-03-11 21:05:45","","TSLA","Tesla Inc (Extended Hours)","",""
"55833667861189","13618.09","-0.21","EURd","SWAP","PROCESSED","2024-03-11 21:05:45","","TSLA","Tesla Inc (Extended Hours)","",""
"55833666812405","13618.3","-0.43","EURd","SWAP","PROCESSED","2024-03-11 21:05:44","","TSLA","Tesla Inc (Extended Hours)","",""
"55833666812285","13618.73","-0.21","EURd","SWAP","PROCESSED","2024-03-11 21:05:44","","TSLA","Tesla Inc (Extended Hours)","",""
"55833666812223","13618.94","-0.43","EURd","SWAP","PROCESSED","2024-03-11 21:05:44","","TSLA","Tesla Inc (Extended Hours)","",""
"55833666811819","13619.37","-0.43","EURd","SWAP","PROCESSED","2024-03-11 21:05:44","","TSLA","Tesla Inc (Extended Hours)","",""
"55743096055433","13619.8","-0.21","EURd","SWAP","PROCESSED","2024-03-10 21:06:09","","TSLA","Tesla Inc (Extended Hours)","",""
"55743095006274","13620.01","-0.21","EURd","SWAP","PROCESSED","2024-03-10 21:06:08","","TSLA","Tesla Inc (Extended Hours)","",""
"55743095006038","13620.22","-0.42","EURd","SWAP","PROCESSED","2024-03-10 21:06:08","","TSLA","Tesla Inc (Extended Hours)","",""
"55743095005881","13620.64","-0.21","EURd","SWAP","PROCESSED","2024-03-10 21:06:08","","TSLA","Tesla Inc (Extended Hours)","",""
"55743095005822","13620.85","-0.42","EURd","SWAP","PROCESSED","2024-03-10 21:06:08","","TSLA","Tesla Inc (Extended Hours)","",""
"55743095005461","13621.27","-0.42","EURd","SWAP","PROCESSED","2024-03-10 21:06:08","","TSLA","Tesla Inc (Extended Hours)","",""
"55743027897734","13621.69","-0.32","EURd","SWAP","PROCESSED","2024-03-10 21:05:04","","GOOGL","Alphabet Inc - A (Extended Hours)","",""
"55743027897654","13622.01","-0.32","EURd","SWAP","PROCESSED","2024-03-10 21:05:04","","GOOGL","Alphabet Inc - A (Extended Hours)","",""
"55656290742012","13622.33","-0.32","EURd","SWAP","PROCESSED","2024-03-09 22:06:25","","GOOGL","Alphabet Inc - A (Extended Hours)","",""
"55656290741912","13622.65","-0.32","EURd","SWAP","PROCESSED","2024-03-09 22:06:25","","GOOGL","Alphabet Inc - A (Extended Hours)","",""
"55656286539049","13622.97","-0.21","EURd","SWAP","PROCESSED","2024-03-09 22:06:21","","TSLA","Tesla Inc (Extended Hours)","",""
"55656286538635","13623.18","-0.21","EURd","SWAP","PROCESSED","2024-03-09 22:06:21","","TSLA","Tesla Inc (Extended Hours)","",""
"55656286538441","13623.39","-0.42","EURd","SWAP","PROCESSED","2024-03-09 22:06:21","","TSLA","Tesla Inc (Extended Hours)","",""
"55656286538339","13623.81","-0.21","EURd","SWAP","PROCESSED","2024-03-09 22:06:21","","TSLA","Tesla Inc (Extended Hours)","",""
"55656286538289","13624.02","-0.42","EURd","SWAP","PROCESSED","2024-03-09 22:06:21","","TSLA","Tesla Inc (Extended Hours)","",""
"55656286537958","13624.44","-0.42","EURd","SWAP","PROCESSED","2024-03-09 22:06:21","","TSLA","Tesla Inc (Extended Hours)","",""
"55565721037680","13624.86","-0.21","EURd","SWAP","PROCESSED","2024-03-08 22:06:51","","TSLA","Tesla Inc (Extended Hours)","",""
"55565721037484","13625.07","-0.21","EURd","SWAP","PROCESSED","2024-03-08 22:06:51","","TSLA","Tesla Inc (Extended Hours)","",""
"55565721037376","13625.28","-0.42","EURd","SWAP","PROCESSED","2024-03-08 22:06:51","","TSLA","Tesla Inc (Extended Hours)","",""
"55565721037040","13625.7","-0.21","EURd","SWAP","PROCESSED","2024-03-08 22:06:51","","TSLA","Tesla Inc (Extended Hours)","",""
"55565721037006","13625.91","-0.42","EURd","SWAP","PROCESSED","2024-03-08 22:06:51","","TSLA","Tesla Inc (Extended Hours)","",""
"55565719988278","13626.33","-0.42","EURd","SWAP","PROCESSED","2024-03-08 22:06:50","","TSLA","Tesla Inc (Extended Hours)","",""
"55565692725440","13626.75","-0.32","EURd","SWAP","PROCESSED","2024-03-08 22:06:24","","GOOGL","Alphabet Inc - A (Extended Hours)","",""
"55565692725277","13627.07","-0.32","EURd","SWAP","PROCESSED","2024-03-08 22:06:24","","GOOGL","Alphabet Inc - A (Extended Hours)","",""
"55475078980400","13627.39","-0.21","EURd","SWAP","PROCESSED","2024-03-07 22:06:08","","TSLA","Tesla Inc (Extended Hours)","",""
"55475077931302","13627.6","-0.21","EURd","SWAP","PROCESSED","2024-03-07 22:06:07","","TSLA","Tesla Inc (Extended Hours)","",""
"55475077931082","13627.81","-0.43","EURd","SWAP","PROCESSED","2024-03-07 22:06:07","","TSLA","Tesla Inc (Extended Hours)","",""
"55475077930910","13628.24","-0.21","EURd","SWAP","PROCESSED","2024-03-07 22:06:07","","TSLA","Tesla Inc (Extended Hours)","",""
"55475077930854","13628.45","-0.43","EURd","SWAP","PROCESSED","2024-03-07 22:06:07","","TSLA","Tesla Inc (Extended Hours)","",""
"55475077930513","13628.88","-0.43","EURd","SWAP","PROCESSED","2024-03-07 22:06:07","","TSLA","Tesla Inc (Extended Hours)","",""
"55475060097151","13629.31","-0.32","EURd","SWAP","PROCESSED","2024-03-07 22:05:50","","GOOGL","Alphabet Inc - A (Extended Hours)","",""
"55475060097024","13629.63","-0.32","EURd","SWAP","PROCESSED","2024-03-07 22:05:50","","GOOGL","Alphabet Inc - A (Extended Hours)","",""
"55384510324214","13629.95","-0.21","EURd","SWAP","PROCESSED","2024-03-06 22:06:35","","TSLA","Tesla Inc (Extended Hours)","",""
"55384510324040","13630.16","-0.21","EURd","SWAP","PROCESSED","2024-03-06 22:06:35","","TSLA","Tesla Inc (Extended Hours)","",""
"55384510323949","13630.37","-0.42","EURd","SWAP","PROCESSED","2024-03-06 22:06:35","","TSLA","Tesla Inc (Extended Hours)","",""
"55384510323888","13630.79","-0.21","EURd","SWAP","PROCESSED","2024-03-06 22:06:35","","TSLA","Tesla Inc (Extended Hours)","",""
"55384510323855","13631","-0.42","EURd","SWAP","PROCESSED","2024-03-06 22:06:35","","TSLA","Tesla Inc (Extended Hours)","",""
"55384510323730","13631.42","-0.42","EURd","SWAP","PROCESSED","2024-03-06 22:06:35","","TSLA","Tesla Inc (Extended Hours)","",""
"55384475729429","13631.84","-0.31","EURd","SWAP","PROCESSED","2024-03-06 22:06:02","","GOOGL","Alphabet Inc - A (Extended Hours)","",""
"55384475729294","13632.15","-0.31","EURd","SWAP","PROCESSED","2024-03-06 22:06:02","","GOOGL","Alphabet Inc - A (Extended Hours)","",""
"55293876651219","13632.46","-0.22","EURd","SWAP","PROCESSED","2024-03-05 22:06:00","","TSLA","Tesla Inc (Extended Hours)","",""
"55293876650705","13632.68","-0.22","EURd","SWAP","PROCESSED","2024-03-05 22:06:00","","TSLA","Tesla Inc (Extended Hours)","",""
"55293876650458","13632.9","-0.44","EURd","SWAP","PROCESSED","2024-03-05 22:06:00","","TSLA","Tesla Inc (Extended Hours)","",""
"55293876650245","13633.34","-0.22","EURd","SWAP","PROCESSED","2024-03-05 22:06:00","","TSLA","Tesla Inc (Extended Hours)","",""
"55293876650160","13633.56","-0.44","EURd","SWAP","PROCESSED","2024-03-05 22:06:00","","TSLA","Tesla Inc (Extended Hours)","",""
"55293876666224","13634","-0.44","EURd","SWAP","PROCESSED","2024-03-05 22:06:00","","TSLA","Tesla Inc (Extended Hours)","",""
"55293817944602","13634.44","-0.32","EURd","SWAP","PROCESSED","2024-03-05 22:05:04","","GOOGL","Alphabet Inc - A (Extended Hours)","",""
"55293817944478","13634.76","-0.32","EURd","SWAP","PROCESSED","2024-03-05 22:05:04","","GOOGL","Alphabet Inc - A (Extended Hours)","",""
"55203302765228","13635.08","-0.23","EURd","SWAP","PROCESSED","2024-03-04 22:06:22","","TSLA","Tesla Inc (Extended Hours)","",""
"55203302764682","13635.31","-0.23","EURd","SWAP","PROCESSED","2024-03-04 22:06:22","","TSLA","Tesla Inc (Extended Hours)","",""
"55203302764437","13635.54","-0.45","EURd","SWAP","PROCESSED","2024-03-04 22:06:22","","TSLA","Tesla Inc (Extended Hours)","",""
"55203302764275","13635.99","-0.23","EURd","SWAP","PROCESSED","2024-03-04 22:06:22","","TSLA","Tesla Inc (Extended Hours)","",""
"55203302764208","13636.22","-0.45","EURd","SWAP","PROCESSED","2024-03-04 22:06:22","","TSLA","Tesla Inc (Extended Hours)","",""
"55203302763826","13636.67","-0.45","EURd","SWAP","PROCESSED","2024-03-04 22:06:22","","TSLA","Tesla Inc (Extended Hours)","",""
"55203225158746","13637.12","-0.32","EURd","SWAP","PROCESSED","2024-03-04 22:05:08","","GOOGL","Alphabet Inc - A (Extended Hours)","",""
"55203225158580","13637.44","-0.32","EURd","SWAP","PROCESSED","2024-03-04 22:05:08","","GOOGL","Alphabet Inc - A (Extended Hours)","",""
"55112698459863","13637.76","-0.25","EURd","SWAP","PROCESSED","2024-03-03 22:06:15","","TSLA","Tesla Inc (Extended Hours)","",""
"55112698459350","13638.01","-0.25","EURd","SWAP","PROCESSED","2024-03-03 22:06:15","","TSLA","Tesla Inc (Extended Hours)","",""
"55112698459052","13638.26","-0.5","EURd","SWAP","PROCESSED","2024-03-03 22:06:15","","TSLA","Tesla Inc (Extended Hours)","",""
"55112698458829","13638.76","-0.25","EURd","SWAP","PROCESSED","2024-03-03 22:06:15","","TSLA","Tesla Inc (Extended Hours)","",""
"55112698458771","13639.01","-0.5","EURd","SWAP","PROCESSED","2024-03-03 22:06:15","","TSLA","Tesla Inc (Extended Hours)","",""
"55112698458397","13639.51","-0.5","EURd","SWAP","PROCESSED","2024-03-03 22:06:15","","TSLA","Tesla Inc (Extended Hours)","",""
"55112635546130","13640.01","-0.33","EURd","SWAP","PROCESSED","2024-03-03 22:05:15","","GOOGL","Alphabet Inc - A (Extended Hours)","",""
"55112635545976","13640.34","-0.33","EURd","SWAP","PROCESSED","2024-03-03 22:05:15","","GOOGL","Alphabet Inc - A (Extended Hours)","",""
"55022087848045","13640.67","-0.25","EURd","SWAP","PROCESSED","2024-03-02 22:06:02","","TSLA","Tesla Inc (Extended Hours)","",""
"55022086815296","13640.92","-0.25","EURd","SWAP","PROCESSED","2024-03-02 22:06:01","","TSLA","Tesla Inc (Extended Hours)","",""
"55022086815046","13641.17","-0.5","EURd","SWAP","PROCESSED","2024-03-02 22:06:01","","TSLA","Tesla Inc (Extended Hours)","",""
"55022086814852","13641.67","-0.25","EURd","SWAP","PROCESSED","2024-03-02 22:06:01","","TSLA","Tesla Inc (Extended Hours)","",""
"55022086814799","13641.92","-0.5","EURd","SWAP","PROCESSED","2024-03-02 22:06:01","","TSLA","Tesla Inc (Extended Hours)","",""
"55022086814397","13642.42","-0.5","EURd","SWAP","PROCESSED","2024-03-02 22:06:01","","TSLA","Tesla Inc (Extended Hours)","",""
"55022048005553","13642.92","-0.33","EURd","SWAP","PROCESSED","2024-03-02 22:05:24","","GOOGL","Alphabet Inc - A (Extended Hours)","",""
"55022048005419","13643.25","-0.33","EURd","SWAP","PROCESSED","2024-03-02 22:05:24","","GOOGL","Alphabet Inc - A (Extended Hours)","",""
"54931527593409","13643.58","-0.33","EURd","SWAP","PROCESSED","2024-03-01 22:06:37","","GOOGL","Alphabet Inc - A (Extended Hours)","",""
"54931527593367","13643.91","-0.33","EURd","SWAP","PROCESSED","2024-03-01 22:06:37","","GOOGL","Alphabet Inc - A (Extended Hours)","",""
"54931506612087","13644.24","-0.25","EURd","SWAP","PROCESSED","2024-03-01 22:06:17","","TSLA","Tesla Inc (Extended Hours)","",""
"54931506611517","13644.49","-0.25","EURd","SWAP","PROCESSED","2024-03-01 22:06:17","","TSLA","Tesla Inc (Extended Hours)","",""
"54931506611274","13644.74","-0.5","EURd","SWAP","PROCESSED","2024-03-01 22:06:17","","TSLA","Tesla Inc (Extended Hours)","",""
"54931506611095","13645.24","-0.25","EURd","SWAP","PROCESSED","2024-03-01 22:06:17","","TSLA","Tesla Inc (Extended Hours)","",""
"54931506611020","13645.49","-0.5","EURd","SWAP","PROCESSED","2024-03-01 22:06:17","","TSLA","Tesla Inc (Extended Hours)","",""
"54931505562087","13645.99","-0.5","EURd","SWAP","PROCESSED","2024-03-01 22:06:16","","TSLA","Tesla Inc (Extended Hours)","",""
"54887746400091","13646.49","15.07","EURd","TRADE","PROCESSED","2024-03-01 10:30:44","000940dd-0055-311e-0000-4d47000683d1_000940dd-0055-311e-0000-000081cdebf1","BTC/USD","Bitcoin / USD","",""
"54840930621776","13631.42","-0.34","EURd","SWAP","PROCESSED","2024-02-29 22:06:37","","GOOGL","Alphabet Inc - A (Extended Hours)","",""
"54840930621739","13631.76","-0.34","EURd","SWAP","PROCESSED","2024-02-29 22:06:37","","GOOGL","Alphabet Inc - A (Extended Hours)","",""
"54840928522646","13632.1","-0.35","EURd","SWAP","PROCESSED","2024-02-29 22:06:35","","BTC/USD","Bitcoin / USD","",""
"54840886585775","13632.45","-0.25","EURd","SWAP","PROCESSED","2024-02-29 22:05:55","","TSLA","Tesla Inc (Extended Hours)","",""
"54840886585311","13632.7","-0.25","EURd","SWAP","PROCESSED","2024-02-29 22:05:55","","TSLA","Tesla Inc (Extended Hours)","",""
"54840886585074","13632.95","-0.49","EURd","SWAP","PROCESSED","2024-02-29 22:05:55","","TSLA","Tesla Inc (Extended Hours)","",""
"54840886584895","13633.44","-0.25","EURd","SWAP","PROCESSED","2024-02-29 22:05:55","","TSLA","Tesla Inc (Extended Hours)","",""
"54840886584840","13633.69","-0.49","EURd","SWAP","PROCESSED","2024-02-29 22:05:55","","TSLA","Tesla Inc (Extended Hours)","",""
"54840885535876","13634.18","-0.49","EURd","SWAP","PROCESSED","2024-02-29 22:05:54","","TSLA","Tesla Inc (Extended Hours)","",""
"54750318978331","13634.67","-0.35","EURd","SWAP","PROCESSED","2024-02-28 22:06:23","","BTC/USD","Bitcoin / USD","",""
"54750290664458","13635.02","-0.33","EURd","SWAP","PROCESSED","2024-02-28 22:05:56","","GOOGL","Alphabet Inc - A (Extended Hours)","",""
"54750290664350","13635.35","-0.33","EURd","SWAP","PROCESSED","2024-02-28 22:05:56","","GOOGL","Alphabet Inc - A (Extended Hours)","",""
"54750250822212","13635.68","-0.25","EURd","SWAP","PROCESSED","2024-02-28 22:05:18","","TSLA","Tesla Inc (Extended Hours)","",""
"54750250821496","13635.93","-0.25","EURd","SWAP","PROCESSED","2024-02-28 22:05:18","","TSLA","Tesla Inc (Extended Hours)","",""
"54750250821171","13636.18","-0.49","EURd","SWAP","PROCESSED","2024-02-28 22:05:18","","TSLA","Tesla Inc (Extended Hours)","",""
"54750250820929","13636.67","-0.25","EURd","SWAP","PROCESSED","2024-02-28 22:05:18","","TSLA","Tesla Inc (Extended Hours)","",""
"54750250820873","13636.92","-0.49","EURd","SWAP","PROCESSED","2024-02-28 22:05:18","","TSLA","Tesla Inc (Extended Hours)","",""
"54750250820563","13637.41","-0.49","EURd","SWAP","PROCESSED","2024-02-28 22:05:18","","TSLA","Tesla Inc (Extended Hours)","",""
"54659736684694","13637.9","-0.25","EURd","SWAP","PROCESSED","2024-02-27 22:06:37","","TSLA","Tesla Inc (Extended Hours)","",""
"54659736684500","13638.15","-0.25","EURd","SWAP","PROCESSED","2024-02-27 22:06:37","","TSLA","Tesla Inc (Extended Hours)","",""
"54659736684404","13638.4","-0.49","EURd","SWAP","PROCESSED","2024-02-27 22:06:37","","TSLA","Tesla Inc (Extended Hours)","",""
"54659736684343","13638.89","-0.25","EURd","SWAP","PROCESSED","2024-02-27 22:06:37","","TSLA","Tesla Inc (Extended Hours)","",""
"54659736684324","13639.14","-0.49","EURd","SWAP","PROCESSED","2024-02-27 22:06:37","","TSLA","Tesla Inc (Extended Hours)","",""
"54659736684217","13639.63","-0.49","EURd","SWAP","PROCESSED","2024-02-27 22:06:37","","TSLA","Tesla Inc (Extended Hours)","",""
"54659734585355","13640.12","-0.34","EURd","SWAP","PROCESSED","2024-02-27 22:06:35","","GOOGL","Alphabet Inc - A (Extended Hours)","",""
"54659734601665","13640.46","-0.34","EURd","SWAP","PROCESSED","2024-02-27 22:06:35","","GOOGL","Alphabet Inc - A (Extended Hours)","",""
"54570069810614","13640.8","-0.24","EURd","SWAP","PROCESSED","2024-02-26 22:21:24","","TSLA","Tesla Inc (Extended Hours)","",""
"54570069810029","13641.04","-0.24","EURd","SWAP","PROCESSED","2024-02-26 22:21:24","","TSLA","Tesla Inc (Extended Hours)","",""
"54570069809732","13641.28","-0.48","EURd","SWAP","PROCESSED","2024-02-26 22:21:24","","TSLA","Tesla Inc (Extended Hours)","",""
"54570069809524","13641.76","-0.24","EURd","SWAP","PROCESSED","2024-02-26 22:21:24","","TSLA","Tesla Inc (Extended Hours)","",""
"54570068760885","13642","-0.48","EURd","SWAP","PROCESSED","2024-02-26 22:21:23","","TSLA","Tesla Inc (Extended Hours)","",""
"54570068760522","13642.48","-0.48","EURd","SWAP","PROCESSED","2024-02-26 22:21:23","","TSLA","Tesla Inc (Extended Hours)","",""
"54570035208258","13642.96","-0.34","EURd","SWAP","PROCESSED","2024-02-26 22:20:51","","GOOGL","Alphabet Inc - A (Extended Hours)","",""
"54570035208112","13643.3","-0.34","EURd","SWAP","PROCESSED","2024-02-26 22:20:51","","GOOGL","Alphabet Inc - A (Extended Hours)","",""
"54479479143231","13643.64","-0.24","EURd","SWAP","PROCESSED","2024-02-25 22:21:30","","TSLA","Tesla Inc (Extended Hours)","",""
"54479478094023","13643.88","-0.24","EURd","SWAP","PROCESSED","2024-02-25 22:21:29","","TSLA","Tesla Inc (Extended Hours)","",""
"54479478093682","13644.12","-0.47","EURd","SWAP","PROCESSED","2024-02-25 22:21:29","","TSLA","Tesla Inc (Extended Hours)","",""
"54479478093463","13644.59","-0.24","EURd","SWAP","PROCESSED","2024-02-25 22:21:29","","TSLA","Tesla Inc (Extended Hours)","",""
"54479478093393","13644.83","-0.47","EURd","SWAP","PROCESSED","2024-02-25 22:21:29","","TSLA","Tesla Inc (Extended Hours)","",""
"54479478093026","13645.3","-0.47","EURd","SWAP","PROCESSED","2024-02-25 22:21:29","","TSLA","Tesla Inc (Extended Hours)","",""
"54479422505693","13645.77","-0.35","EURd","SWAP","PROCESSED","2024-02-25 22:20:36","","GOOGL","Alphabet Inc - A (Extended Hours)","",""
"54479421456977","13646.12","-0.35","EURd","SWAP","PROCESSED","2024-02-25 22:20:35","","GOOGL","Alphabet Inc - A (Extended Hours)","",""
"54388837084572","13646.47","-0.24","EURd","SWAP","PROCESSED","2024-02-24 22:20:47","","TSLA","Tesla Inc (Extended Hours)","",""
"54388837083980","13646.71","-0.24","EURd","SWAP","PROCESSED","2024-02-24 22:20:47","","TSLA","Tesla Inc (Extended Hours)","",""
"54388836035018","13646.95","-0.47","EURd","SWAP","PROCESSED","2024-02-24 22:20:46","","TSLA","Tesla Inc (Extended Hours)","",""
"54388836034813","13647.42","-0.24","EURd","SWAP","PROCESSED","2024-02-24 22:20:46","","TSLA","Tesla Inc (Extended Hours)","",""
"54388836034757","13647.66","-0.47","EURd","SWAP","PROCESSED","2024-02-24 22:20:46","","TSLA","Tesla Inc (Extended Hours)","",""
"54388836034399","13648.13","-0.47","EURd","SWAP","PROCESSED","2024-02-24 22:20:46","","TSLA","Tesla Inc (Extended Hours)","",""
"54388817164799","13648.6","-0.35","EURd","SWAP","PROCESSED","2024-02-24 22:20:28","","GOOGL","Alphabet Inc - A (Extended Hours)","",""
"54388817164670","13648.95","-0.35","EURd","SWAP","PROCESSED","2024-02-24 22:20:28","","GOOGL","Alphabet Inc - A (Extended Hours)","",""
"54298295690883","13649.3","-0.24","EURd","SWAP","PROCESSED","2024-02-23 22:21:40","","TSLA","Tesla Inc (Extended Hours)","",""
"54298294641876","13649.54","-0.24","EURd","SWAP","PROCESSED","2024-02-23 22:21:39","","TSLA","Tesla Inc (Extended Hours)","",""
"54298294641640","13649.78","-0.47","EURd","SWAP","PROCESSED","2024-02-23 22:21:39","","TSLA","Tesla Inc (Extended Hours)","",""
"54298294641485","13650.25","-0.24","EURd","SWAP","PROCESSED","2024-02-23 22:21:39","","TSLA","Tesla Inc (Extended Hours)","",""
"54298294641442","13650.49","-0.47","EURd","SWAP","PROCESSED","2024-02-23 22:21:39","","TSLA","Tesla Inc (Extended Hours)","",""
"54298294641167","13650.96","-0.47","EURd","SWAP","PROCESSED","2024-02-23 22:21:39","","TSLA","Tesla Inc (Extended Hours)","",""
"54298214950417","13651.43","-0.35","EURd","SWAP","PROCESSED","2024-02-23 22:20:23","","GOOGL","Alphabet Inc - A (Extended Hours)","",""
"54298213901495","13651.78","-0.35","EURd","SWAP","PROCESSED","2024-02-23 22:20:22","","GOOGL","Alphabet Inc - A (Extended Hours)","",""
"54207700815922","13652.13","-0.35","EURd","SWAP","PROCESSED","2024-02-22 22:21:42","","GOOGL","Alphabet Inc - A (Extended Hours)","",""
"54207699767230","13652.48","-0.35","EURd","SWAP","PROCESSED","2024-02-22 22:21:41","","GOOGL","Alphabet Inc - A (Extended Hours)","",""
"54207602259879","13652.83","-0.24","EURd","SWAP","PROCESSED","2024-02-22 22:20:08","","TSLA","Tesla Inc (Extended Hours)","",""
"54207602259295","13653.07","-0.24","EURd","SWAP","PROCESSED","2024-02-22 22:20:08","","TSLA","Tesla Inc (Extended Hours)","",""
"54207602258995","13653.31","-0.48","EURd","SWAP","PROCESSED","2024-02-22 22:20:08","","TSLA","Tesla Inc (Extended Hours)","",""
"54207601210172","13653.79","-0.24","EURd","SWAP","PROCESSED","2024-02-22 22:20:07","","TSLA","Tesla Inc (Extended Hours)","",""
"54207601209970","13654.03","-0.48","EURd","SWAP","PROCESSED","2024-02-22 22:20:07","","TSLA","Tesla Inc (Extended Hours)","",""
"54207601209600","13654.51","-0.48","EURd","SWAP","PROCESSED","2024-02-22 22:20:07","","TSLA","Tesla Inc (Extended Hours)","",""
"54117137408948","13654.99","-0.24","EURd","SWAP","PROCESSED","2024-02-21 22:22:14","","TSLA","Tesla Inc (Extended Hours)","",""
"54117137408420","13655.23","-0.24","EURd","SWAP","PROCESSED","2024-02-21 22:22:14","","TSLA","Tesla Inc (Extended Hours)","",""
"54117137408150","13655.47","-0.48","EURd","SWAP","PROCESSED","2024-02-21 22:22:14","","TSLA","Tesla Inc (Extended Hours)","",""
"54117137407891","13655.95","-0.24","EURd","SWAP","PROCESSED","2024-02-21 22:22:14","","TSLA","Tesla Inc (Extended Hours)","",""
"54117137407810","13656.19","-0.48","EURd","SWAP","PROCESSED","2024-02-21 22:22:14","","TSLA","Tesla Inc (Extended Hours)","",""
"54117136358888","13656.67","-0.48","EURd","SWAP","PROCESSED","2024-02-21 22:22:13","","TSLA","Tesla Inc (Extended Hours)","",""
"54117043039433","13657.15","-0.35","EURd","SWAP","PROCESSED","2024-02-21 22:20:44","","GOOGL","Alphabet Inc - A (Extended Hours)","",""
"54117043039188","13657.5","-0.35","EURd","SWAP","PROCESSED","2024-02-21 22:20:44","","GOOGL","Alphabet Inc - A (Extended Hours)","",""
"54026535199268","13657.85","-0.34","EURd","SWAP","PROCESSED","2024-02-20 22:22:09","","GOOGL","Alphabet Inc - A (Extended Hours)","",""
"54026535199154","13658.19","-0.34","EURd","SWAP","PROCESSED","2024-02-20 22:22:09","","GOOGL","Alphabet Inc - A (Extended Hours)","",""
"54026417750707","13658.53","-0.24","EURd","SWAP","PROCESSED","2024-02-20 22:20:17","","TSLA","Tesla Inc (Extended Hours)","",""
"54026416701573","13658.77","-0.24","EURd","SWAP","PROCESSED","2024-02-20 22:20:16","","TSLA","Tesla Inc (Extended Hours)","",""
"54026416717636","13659.01","-0.47","EURd","SWAP","PROCESSED","2024-02-20 22:20:16","","TSLA","Tesla Inc (Extended Hours)","",""
"54026416717312","13659.48","-0.24","EURd","SWAP","PROCESSED","2024-02-20 22:20:16","","TSLA","Tesla Inc (Extended Hours)","",""
"54026416717252","13659.72","-0.47","EURd","SWAP","PROCESSED","2024-02-20 22:20:16","","TSLA","Tesla Inc (Extended Hours)","",""
"54026415668276","13660.19","-0.47","EURd","SWAP","PROCESSED","2024-02-20 22:20:15","","TSLA","Tesla Inc (Extended Hours)","",""
"54025716263731","13660.66","16.18","EURd","TRADE","PROCESSED","2024-02-20 22:09:08","0015421d-0055-311e-0000-4d3d000b3f17_0015421d-0055-311e-0000-000080f94b1b","ETH/USD","Ethereum / USD","",""
"53976797040845","13644.48","9.56","EURd","TRADE","PROCESSED","2024-02-20 09:11:35","00081081-0055-311e-0000-4d3d0001b5c0_00081081-0055-311e-0000-0000802f0321","BABA","Alibaba Group Holding Limited (Extended Hours)","",""
"53976793895111","13634.92","16.33","EURd","TRADE","PROCESSED","2024-02-20 09:11:32","0024e503-0055-311e-0000-4d3d0001b5ae_0024e503-0055-311e-0000-0000802e01e2","INTC","Intel Corp (Extended Hours)","",""
"53935957113856","13618.59","-0.25","EURd","SWAP","PROCESSED","2024-02-19 22:22:27","","TSLA","Tesla Inc (Extended Hours)","",""
"53935957113539","13618.84","-0.25","EURd","SWAP","PROCESSED","2024-02-19 22:22:27","","TSLA","Tesla Inc (Extended Hours)","",""
"53935957113364","13619.09","-0.49","EURd","SWAP","PROCESSED","2024-02-19 22:22:27","","TSLA","Tesla Inc (Extended Hours)","",""
"53935956064591","13619.58","-0.25","EURd","SWAP","PROCESSED","2024-02-19 22:22:26","","TSLA","Tesla Inc (Extended Hours)","",""
"53935956064561","13619.83","-0.49","EURd","SWAP","PROCESSED","2024-02-19 22:22:26","","TSLA","Tesla Inc (Extended Hours)","",""
"53935956064339","13620.32","-0.49","EURd","SWAP","PROCESSED","2024-02-19 22:22:26","","TSLA","Tesla Inc (Extended Hours)","",""
"53935952915828","13620.81","-0.19","EURd","SWAP","PROCESSED","2024-02-19 22:22:23","","BABA","Alibaba Group Holding Limited (Extended Hours)","",""
"53935932985132","13621","-0.21","EURd","SWAP","PROCESSED","2024-02-19 22:22:04","","INTC","Intel Corp (Extended Hours)","",""
"53935894197122","13621.21","-0.34","EURd","SWAP","PROCESSED","2024-02-19 22:21:27","","GOOGL","Alphabet Inc - A (Extended Hours)","",""
"53845363285851","13621.55","-0.25","EURd","SWAP","PROCESSED","2024-02-18 22:22:30","","TSLA","Tesla Inc (Extended Hours)","",""
"53845362236927","13621.8","-0.25","EURd","SWAP","PROCESSED","2024-02-18 22:22:29","","TSLA","Tesla Inc (Extended Hours)","",""
"53845362236714","13622.05","-0.49","EURd","SWAP","PROCESSED","2024-02-18 22:22:29","","TSLA","Tesla Inc (Extended Hours)","",""
"53845362236511","13622.54","-0.25","EURd","SWAP","PROCESSED","2024-02-18 22:22:29","","TSLA","Tesla Inc (Extended Hours)","",""
"53845362236461","13622.79","-0.49","EURd","SWAP","PROCESSED","2024-02-18 22:22:29","","TSLA","Tesla Inc (Extended Hours)","",""
"53845362236226","13623.28","-0.49","EURd","SWAP","PROCESSED","2024-02-18 22:22:29","","TSLA","Tesla Inc (Extended Hours)","",""
"53845254238365","13623.77","-0.19","EURd","SWAP","PROCESSED","2024-02-18 22:20:46","","BABA","Alibaba Group Holding Limited (Extended Hours)","",""
"53845244804436","13623.96","-0.21","EURd","SWAP","PROCESSED","2024-02-18 22:20:37","","INTC","Intel Corp (Extended Hours)","",""
"53845212289571","13624.17","-0.34","EURd","SWAP","PROCESSED","2024-02-18 22:20:06","","GOOGL","Alphabet Inc - A (Extended Hours)","",""
"53754755838318","13624.51","-0.34","EURd","SWAP","PROCESSED","2024-02-17 22:22:20","","GOOGL","Alphabet Inc - A (Extended Hours)","",""
"53754742206007","13624.85","-0.21","EURd","SWAP","PROCESSED","2024-02-17 22:22:07","","INTC","Intel Corp (Extended Hours)","",""
"53754696070433","13625.06","-0.25","EURd","SWAP","PROCESSED","2024-02-17 22:21:23","","TSLA","Tesla Inc (Extended Hours)","",""
"53754696069827","13625.31","-0.25","EURd","SWAP","PROCESSED","2024-02-17 22:21:23","","TSLA","Tesla Inc (Extended Hours)","",""
"53754696069439","13625.56","-0.49","EURd","SWAP","PROCESSED","2024-02-17 22:21:23","","TSLA","Tesla Inc (Extended Hours)","",""
"53754695020441","13626.05","-0.25","EURd","SWAP","PROCESSED","2024-02-17 22:21:22","","TSLA","Tesla Inc (Extended Hours)","",""
"53754695020390","13626.3","-0.49","EURd","SWAP","PROCESSED","2024-02-17 22:21:22","","TSLA","Tesla Inc (Extended Hours)","",""
"53754695019967","13626.79","-0.49","EURd","SWAP","PROCESSED","2024-02-17 22:21:22","","TSLA","Tesla Inc (Extended Hours)","",""
"53754681385799","13627.28","-0.19","EURd","SWAP","PROCESSED","2024-02-17 22:21:09","","BABA","Alibaba Group Holding Limited (Extended Hours)","",""
"53664068695258","13627.47","-0.19","EURd","SWAP","PROCESSED","2024-02-16 22:20:54","","BABA","Alibaba Group Holding Limited (Extended Hours)","",""
"53664067644712","13627.66","-0.21","EURd","SWAP","PROCESSED","2024-02-16 22:20:53","","INTC","Intel Corp (Extended Hours)","",""
"53664047726150","13627.87","-0.25","EURd","SWAP","PROCESSED","2024-02-16 22:20:34","","TSLA","Tesla Inc (Extended Hours)","",""
"53664047725523","13628.12","-0.25","EURd","SWAP","PROCESSED","2024-02-16 22:20:34","","TSLA","Tesla Inc (Extended Hours)","",""
"53664047725151","13628.37","-0.49","EURd","SWAP","PROCESSED","2024-02-16 22:20:34","","TSLA","Tesla Inc (Extended Hours)","",""
"53664046676133","13628.86","-0.25","EURd","SWAP","PROCESSED","2024-02-16 22:20:33","","TSLA","Tesla Inc (Extended Hours)","",""
"53664046676072","13629.11","-0.49","EURd","SWAP","PROCESSED","2024-02-16 22:20:33","","TSLA","Tesla Inc (Extended Hours)","",""
"53664046675702","13629.6","-0.49","EURd","SWAP","PROCESSED","2024-02-16 22:20:33","","TSLA","Tesla Inc (Extended Hours)","",""
"53664043524806","13630.09","-0.34","EURd","SWAP","PROCESSED","2024-02-16 22:20:30","","GOOGL","Alphabet Inc - A (Extended Hours)","",""
"53573576582175","13630.43","-0.19","EURd","SWAP","PROCESSED","2024-02-15 22:22:34","","BABA","Alibaba Group Holding Limited (Extended Hours)","",""
"53573556655078","13630.62","-0.22","EURd","SWAP","PROCESSED","2024-02-15 22:22:15","","INTC","Intel Corp (Extended Hours)","",""
"53573496886158","13630.84","-0.35","EURd","SWAP","PROCESSED","2024-02-15 22:21:18","","GOOGL","Alphabet Inc - A (Extended Hours)","",""
"53573485353948","13631.19","-0.25","EURd","SWAP","PROCESSED","2024-02-15 22:21:07","","TSLA","Tesla Inc (Extended Hours)","",""
"53573485353321","13631.44","-0.25","EURd","SWAP","PROCESSED","2024-02-15 22:21:07","","TSLA","Tesla Inc (Extended Hours)","",""
"53573484304292","13631.69","-0.49","EURd","SWAP","PROCESSED","2024-02-15 22:21:06","","TSLA","Tesla Inc (Extended Hours)","",""
"53573484303906","13632.18","-0.25","EURd","SWAP","PROCESSED","2024-02-15 22:21:06","","TSLA","Tesla Inc (Extended Hours)","",""
"53573484303824","13632.43","-0.49","EURd","SWAP","PROCESSED","2024-02-15 22:21:06","","TSLA","Tesla Inc (Extended Hours)","",""
"53573484303420","13632.92","-0.49","EURd","SWAP","PROCESSED","2024-02-15 22:21:06","","TSLA","Tesla Inc (Extended Hours)","",""
"53482978562114","13633.41","-0.19","EURd","SWAP","PROCESSED","2024-02-14 22:22:33","","BABA","Alibaba Group Holding Limited (Extended Hours)","",""
"53482873700377","13633.6","-0.22","EURd","SWAP","PROCESSED","2024-02-14 22:20:53","","INTC","Intel Corp (Extended Hours)","",""
"53482851681739","13633.82","-0.23","EURd","SWAP","PROCESSED","2024-02-14 22:20:32","","TSLA","Tesla Inc (Extended Hours)","",""
"53482850632615","13634.05","-0.23","EURd","SWAP","PROCESSED","2024-02-14 22:20:31","","TSLA","Tesla Inc (Extended Hours)","",""
"53482850632192","13634.28","-0.47","EURd","SWAP","PROCESSED","2024-02-14 22:20:31","","TSLA","Tesla Inc (Extended Hours)","",""
"53482850631774","13634.75","-0.23","EURd","SWAP","PROCESSED","2024-02-14 22:20:31","","TSLA","Tesla Inc (Extended Hours)","",""
"53482850631702","13634.98","-0.47","EURd","SWAP","PROCESSED","2024-02-14 22:20:31","","TSLA","Tesla Inc (Extended Hours)","",""
"53482849599137","13635.45","-0.47","EURd","SWAP","PROCESSED","2024-02-14 22:20:30","","TSLA","Tesla Inc (Extended Hours)","",""
"53482842249188","13635.92","-0.35","EURd","SWAP","PROCESSED","2024-02-14 22:20:23","","GOOGL","Alphabet Inc - A (Extended Hours)","",""
"53427975510898","13636.27","7.56","EURd","TRADE","PROCESSED","2024-02-14 07:48:18","00016258-0055-311e-0000-4d3700034c83_00016258-0055-311e-0000-0000805115f8","VIX","Volatility Index","",""
"53427975510897","13628.71","-17.36","EURd","TRADE","PROCESSED","2024-02-14 07:48:18","00016258-0055-311e-0000-4d3700034c82_00016258-0055-311e-0000-00008051124d","VIX","Volatility Index","",""
"53392360629227","13646.07","-0.75","EURd","SWAP","PROCESSED","2024-02-13 22:22:13","","VIX","Volatility Index","",""
"53392360629181","13646.82","-0.75","EURd","SWAP","PROCESSED","2024-02-13 22:22:13","","VIX","Volatility Index","",""
"53392310293665","13647.57","-0.36","EURd","SWAP","PROCESSED","2024-02-13 22:21:25","","GOOGL","Alphabet Inc - A (Extended Hours)","",""
"53392304010271","13647.93","-0.23","EURd","SWAP","PROCESSED","2024-02-13 22:21:19","","TSLA","Tesla Inc (Extended Hours)","",""
"53392304009681","13648.16","-0.23","EURd","SWAP","PROCESSED","2024-02-13 22:21:19","","TSLA","Tesla Inc (Extended Hours)","",""
"53392304009216","13648.39","-0.46","EURd","SWAP","PROCESSED","2024-02-13 22:21:19","","TSLA","Tesla Inc (Extended Hours)","",""
"53392302960239","13648.85","-0.23","EURd","SWAP","PROCESSED","2024-02-13 22:21:18","","TSLA","Tesla Inc (Extended Hours)","",""
"53392302960172","13649.08","-0.46","EURd","SWAP","PROCESSED","2024-02-13 22:21:18","","TSLA","Tesla Inc (Extended Hours)","",""
"53392302959791","13649.54","-0.46","EURd","SWAP","PROCESSED","2024-02-13 22:21:18","","TSLA","Tesla Inc (Extended Hours)","",""
"53301769954431","13650","-1.43","EURd","SWAP","PROCESSED","2024-02-12 22:22:19","","VIX","Volatility Index","",""
"53301769954378","13651.43","-1.43","EURd","SWAP","PROCESSED","2024-02-12 22:22:19","","VIX","Volatility Index","",""
"53301737454247","13652.86","-0.36","EURd","SWAP","PROCESSED","2024-02-12 22:21:48","","GOOGL","Alphabet Inc - A (Extended Hours)","",""
"53301728005730","13653.22","-0.23","EURd","SWAP","PROCESSED","2024-02-12 22:21:39","","TSLA","Tesla Inc (Extended Hours)","",""
"53301728005079","13653.45","-0.23","EURd","SWAP","PROCESSED","2024-02-12 22:21:39","","TSLA","Tesla Inc (Extended Hours)","",""
"53301728004587","13653.68","-0.46","EURd","SWAP","PROCESSED","2024-02-12 22:21:39","","TSLA","Tesla Inc (Extended Hours)","",""
"53301726955545","13654.14","-0.23","EURd","SWAP","PROCESSED","2024-02-12 22:21:38","","TSLA","Tesla Inc (Extended Hours)","",""
"53301726955473","13654.37","-0.46","EURd","SWAP","PROCESSED","2024-02-12 22:21:38","","TSLA","Tesla Inc (Extended Hours)","",""
"53301726955075","13654.83","-0.46","EURd","SWAP","PROCESSED","2024-02-12 22:21:38","","TSLA","Tesla Inc (Extended Hours)","",""
"53211133147235","13655.29","-1.29","EURd","SWAP","PROCESSED","2024-02-11 22:21:41","","VIX","Volatility Index","",""
"53211132098605","13656.58","-1.29","EURd","SWAP","PROCESSED","2024-02-11 22:21:40","","VIX","Volatility Index","",""
"53211086995839","13657.87","-0.24","EURd","SWAP","PROCESSED","2024-02-11 22:20:57","","TSLA","Tesla Inc (Extended Hours)","",""
"53211087011603","13658.11","-0.24","EURd","SWAP","PROCESSED","2024-02-11 22:20:57","","TSLA","Tesla Inc (Extended Hours)","",""
"53211085962521","13658.35","-0.47","EURd","SWAP","PROCESSED","2024-02-11 22:20:56","","TSLA","Tesla Inc (Extended Hours)","",""
"53211085962090","13658.82","-0.24","EURd","SWAP","PROCESSED","2024-02-11 22:20:56","","TSLA","Tesla Inc (Extended Hours)","",""
"53211085962018","13659.06","-0.47","EURd","SWAP","PROCESSED","2024-02-11 22:20:56","","TSLA","Tesla Inc (Extended Hours)","",""
"53211085961646","13659.53","-0.47","EURd","SWAP","PROCESSED","2024-02-11 22:20:56","","TSLA","Tesla Inc (Extended Hours)","",""
"53158187395240","13660","143.59","EURd","TRADE","PROCESSED","2024-02-11 08:20:08","0015421d-0055-311e-0000-4d340002b336_0015421d-0055-311e-0000-000080ef422f","ETH/USD","Ethereum / USD","",""
"53120595947553","13516.41","-0.24","EURd","SWAP","PROCESSED","2024-02-10 22:22:38","","TSLA","Tesla Inc (Extended Hours)","",""
"53120595947342","13516.65","-0.24","EURd","SWAP","PROCESSED","2024-02-10 22:22:38","","TSLA","Tesla Inc (Extended Hours)","",""
"53120594898596","13516.89","-0.47","EURd","SWAP","PROCESSED","2024-02-10 22:22:37","","TSLA","Tesla Inc (Extended Hours)","",""
"53120594898434","13517.36","-0.24","EURd","SWAP","PROCESSED","2024-02-10 22:22:37","","TSLA","Tesla Inc (Extended Hours)","",""
"53120594898416","13517.6","-0.47","EURd","SWAP","PROCESSED","2024-02-10 22:22:37","","TSLA","Tesla Inc (Extended Hours)","",""
"53120594898271","13518.07","-0.47","EURd","SWAP","PROCESSED","2024-02-10 22:22:37","","TSLA","Tesla Inc (Extended Hours)","",""
"53120527790443","13518.54","-1.29","EURd","SWAP","PROCESSED","2024-02-10 22:21:33","","VIX","Volatility Index","",""
"53120527790397","13519.83","-1.29","EURd","SWAP","PROCESSED","2024-02-10 22:21:33","","VIX","Volatility Index","",""
"53120505771116","13521.12","-1.44","EURd","SWAP","PROCESSED","2024-02-10 22:21:12","","ETH/USD","Ethereum / USD","",""
"53029966475320","13522.56","-1.29","EURd","SWAP","PROCESSED","2024-02-09 22:22:07","","VIX","Volatility Index","",""
"53029966475262","13523.85","-1.29","EURd","SWAP","PROCESSED","2024-02-09 22:22:07","","VIX","Volatility Index","",""
"53029888869612","13525.14","-1.44","EURd","SWAP","PROCESSED","2024-02-09 22:20:53","","ETH/USD","Ethereum / USD","",""
"53029868951292","13526.58","-0.24","EURd","SWAP","PROCESSED","2024-02-09 22:20:34","","TSLA","Tesla Inc (Extended Hours)","",""
"53029868950610","13526.82","-0.24","EURd","SWAP","PROCESSED","2024-02-09 22:20:34","","TSLA","Tesla Inc (Extended Hours)","",""
"53029868950114","13527.06","-0.47","EURd","SWAP","PROCESSED","2024-02-09 22:20:34","","TSLA","Tesla Inc (Extended Hours)","",""
"53029867901064","13527.53","-0.24","EURd","SWAP","PROCESSED","2024-02-09 22:20:33","","TSLA","Tesla Inc (Extended Hours)","",""
"53029867901002","13527.77","-0.47","EURd","SWAP","PROCESSED","2024-02-09 22:20:33","","TSLA","Tesla Inc (Extended Hours)","",""
"53029867900630","13528.24","-0.47","EURd","SWAP","PROCESSED","2024-02-09 22:20:33","","TSLA","Tesla Inc (Extended Hours)","",""
"52939353783460","13528.71","-1.15","EURd","SWAP","PROCESSED","2024-02-08 22:21:52","","VIX","Volatility Index","",""
"52939353783387","13529.86","-1.15","EURd","SWAP","PROCESSED","2024-02-08 22:21:52","","VIX","Volatility Index","",""
"52939320215857","13531.01","-0.23","EURd","SWAP","PROCESSED","2024-02-08 22:21:20","","TSLA","Tesla Inc (Extended Hours)","",""
"52939319166580","13531.24","-0.23","EURd","SWAP","PROCESSED","2024-02-08 22:21:19","","TSLA","Tesla Inc (Extended Hours)","",""
"52939319166084","13531.47","-0.46","EURd","SWAP","PROCESSED","2024-02-08 22:21:19","","TSLA","Tesla Inc (Extended Hours)","",""
"52939318117035","13531.93","-0.23","EURd","SWAP","PROCESSED","2024-02-08 22:21:18","","TSLA","Tesla Inc (Extended Hours)","",""
"52939318116987","13532.16","-0.46","EURd","SWAP","PROCESSED","2024-02-08 22:21:18","","TSLA","Tesla Inc (Extended Hours)","",""
"52939318116601","13532.62","-0.46","EURd","SWAP","PROCESSED","2024-02-08 22:21:18","","TSLA","Tesla Inc (Extended Hours)","",""
"52939251013434","13533.08","-1.39","EURd","SWAP","PROCESSED","2024-02-08 22:20:14","","ETH/USD","Ethereum / USD","",""
"52848758899247","13534.47","-0.23","EURd","SWAP","PROCESSED","2024-02-07 22:21:54","","TSLA","Tesla Inc (Extended Hours)","",""
"52848758914897","13534.7","-0.23","EURd","SWAP","PROCESSED","2024-02-07 22:21:54","","TSLA","Tesla Inc (Extended Hours)","",""
"52848757865880","13534.93","-0.46","EURd","SWAP","PROCESSED","2024-02-07 22:21:53","","TSLA","Tesla Inc (Extended Hours)","",""
"52848757865411","13535.39","-0.23","EURd","SWAP","PROCESSED","2024-02-07 22:21:53","","TSLA","Tesla Inc (Extended Hours)","",""
"52848757865343","13535.62","-0.46","EURd","SWAP","PROCESSED","2024-02-07 22:21:53","","TSLA","Tesla Inc (Extended Hours)","",""
"52848757864976","13536.08","-0.46","EURd","SWAP","PROCESSED","2024-02-07 22:21:53","","TSLA","Tesla Inc (Extended Hours)","",""
"52848708576230","13536.54","-1.15","EURd","SWAP","PROCESSED","2024-02-07 22:21:06","","VIX","Volatility Index","",""
"52848708576174","13537.69","-1.15","EURd","SWAP","PROCESSED","2024-02-07 22:21:06","","VIX","Volatility Index","",""
"52848646705078","13538.84","-1.39","EURd","SWAP","PROCESSED","2024-02-07 22:20:07","","ETH/USD","Ethereum / USD","",""
"52758113702900","13540.23","-0.23","EURd","SWAP","PROCESSED","2024-02-06 22:21:08","","TSLA","Tesla Inc (Extended Hours)","",""
"52758113702240","13540.46","-0.23","EURd","SWAP","PROCESSED","2024-02-06 22:21:08","","TSLA","Tesla Inc (Extended Hours)","",""
"52758113701744","13540.69","-0.46","EURd","SWAP","PROCESSED","2024-02-06 22:21:08","","TSLA","Tesla Inc (Extended Hours)","",""
"52758112652699","13541.15","-0.23","EURd","SWAP","PROCESSED","2024-02-06 22:21:07","","TSLA","Tesla Inc (Extended Hours)","",""
"52758112652621","13541.38","-0.46","EURd","SWAP","PROCESSED","2024-02-06 22:21:07","","TSLA","Tesla Inc (Extended Hours)","",""
"52758112652231","13541.84","-0.46","EURd","SWAP","PROCESSED","2024-02-06 22:21:07","","TSLA","Tesla Inc (Extended Hours)","",""
"52758059177711","13542.3","-1.37","EURd","SWAP","PROCESSED","2024-02-06 22:20:16","","ETH/USD","Ethereum / USD","",""
"52758043444571","13543.67","-1.15","EURd","SWAP","PROCESSED","2024-02-06 22:20:01","","VIX","Volatility Index","",""
"52758043444523","13544.82","-1.15","EURd","SWAP","PROCESSED","2024-02-06 22:20:01","","VIX","Volatility Index","",""
"52667581749600","13545.97","-0.22","EURd","SWAP","PROCESSED","2024-02-05 22:22:10","","TSLA","Tesla Inc (Extended Hours)","",""
"52667581749090","13546.19","-0.22","EURd","SWAP","PROCESSED","2024-02-05 22:22:10","","TSLA","Tesla Inc (Extended Hours)","",""
"52667580700133","13546.41","-0.45","EURd","SWAP","PROCESSED","2024-02-05 22:22:09","","TSLA","Tesla Inc (Extended Hours)","",""
"52667580699766","13546.86","-0.22","EURd","SWAP","PROCESSED","2024-02-05 22:22:09","","TSLA","Tesla Inc (Extended Hours)","",""
"52667580699732","13547.08","-0.45","EURd","SWAP","PROCESSED","2024-02-05 22:22:09","","TSLA","Tesla Inc (Extended Hours)","",""
"52667580699420","13547.53","-0.45","EURd","SWAP","PROCESSED","2024-02-05 22:22:09","","TSLA","Tesla Inc (Extended Hours)","",""
"52667466404459","13547.98","-1.32","EURd","SWAP","PROCESSED","2024-02-05 22:20:20","","ETH/USD","Ethereum / USD","",""
"52667461170535","13549.3","-1.15","EURd","SWAP","PROCESSED","2024-02-05 22:20:15","","VIX","Volatility Index","",""
"52667461170476","13550.45","-1.15","EURd","SWAP","PROCESSED","2024-02-05 22:20:15","","VIX","Volatility Index","",""
"52576894608094","13551.6","-1.32","EURd","SWAP","PROCESSED","2024-02-04 22:20:44","","ETH/USD","Ethereum / USD","",""
"52576885173219","13552.92","-0.23","EURd","SWAP","PROCESSED","2024-02-04 22:20:35","","TSLA","Tesla Inc (Extended Hours)","",""
"52576884123993","13553.15","-0.23","EURd","SWAP","PROCESSED","2024-02-04 22:20:34","","TSLA","Tesla Inc (Extended Hours)","",""
"52576884123483","13553.38","-0.46","EURd","SWAP","PROCESSED","2024-02-04 22:20:34","","TSLA","Tesla Inc (Extended Hours)","",""
"52576883074455","13553.84","-0.23","EURd","SWAP","PROCESSED","2024-02-04 22:20:33","","TSLA","Tesla Inc (Extended Hours)","",""
"52576883074393","13554.07","-0.46","EURd","SWAP","PROCESSED","2024-02-04 22:20:33","","TSLA","Tesla Inc (Extended Hours)","",""
"52576883074053","13554.53","-0.46","EURd","SWAP","PROCESSED","2024-02-04 22:20:33","","TSLA","Tesla Inc (Extended Hours)","",""
"52576876773838","13554.99","-0.97","EURd","SWAP","PROCESSED","2024-02-04 22:20:27","","VIX","Volatility Index","",""
"52576876773764","13555.96","-0.97","EURd","SWAP","PROCESSED","2024-02-04 22:20:27","","VIX","Volatility Index","",""
"52486375233506","13556.93","-1.32","EURd","SWAP","PROCESSED","2024-02-03 22:21:58","","ETH/USD","Ethereum / USD","",""
"52486344828672","13558.25","-0.23","EURd","SWAP","PROCESSED","2024-02-03 22:21:29","","TSLA","Tesla Inc (Extended Hours)","",""
"52486344828050","13558.48","-0.23","EURd","SWAP","PROCESSED","2024-02-03 22:21:29","","TSLA","Tesla Inc (Extended Hours)","",""
"52486343779006","13558.71","-0.46","EURd","SWAP","PROCESSED","2024-02-03 22:21:28","","TSLA","Tesla Inc (Extended Hours)","",""
"52486343778561","13559.17","-0.23","EURd","SWAP","PROCESSED","2024-02-03 22:21:28","","TSLA","Tesla Inc (Extended Hours)","",""
"52486343778522","13559.4","-0.46","EURd","SWAP","PROCESSED","2024-02-03 22:21:28","","TSLA","Tesla Inc (Extended Hours)","",""
"52486343778055","13559.86","-0.46","EURd","SWAP","PROCESSED","2024-02-03 22:21:28","","TSLA","Tesla Inc (Extended Hours)","",""
"52486335394815","13560.32","-0.97","EURd","SWAP","PROCESSED","2024-02-03 22:21:20","","VIX","Volatility Index","",""
"52486335394742","13561.29","-0.97","EURd","SWAP","PROCESSED","2024-02-03 22:21:20","","VIX","Volatility Index","",""
"52395759399054","13562.26","-1.33","EURd","SWAP","PROCESSED","2024-02-02 22:21:40","","ETH/USD","Ethereum / USD","",""
"52395749963712","13563.59","-0.23","EURd","SWAP","PROCESSED","2024-02-02 22:21:31","","TSLA","Tesla Inc (Extended Hours)","",""
"52395748914589","13563.82","-0.23","EURd","SWAP","PROCESSED","2024-02-02 22:21:30","","TSLA","Tesla Inc (Extended Hours)","",""
"52395748914124","13564.05","-0.46","EURd","SWAP","PROCESSED","2024-02-02 22:21:30","","TSLA","Tesla Inc (Extended Hours)","",""
"52395748913656","13564.51","-0.23","EURd","SWAP","PROCESSED","2024-02-02 22:21:30","","TSLA","Tesla Inc (Extended Hours)","",""
"52395748913596","13564.74","-0.46","EURd","SWAP","PROCESSED","2024-02-02 22:21:30","","TSLA","Tesla Inc (Extended Hours)","",""
"52395748913172","13565.2","-0.46","EURd","SWAP","PROCESSED","2024-02-02 22:21:30","","TSLA","Tesla Inc (Extended Hours)","",""
"52395737378038","13565.66","-0.97","EURd","SWAP","PROCESSED","2024-02-02 22:21:19","","VIX","Volatility Index","",""
"52395736329399","13566.63","-0.97","EURd","SWAP","PROCESSED","2024-02-02 22:21:18","","VIX","Volatility Index","",""
"52305198086120","13567.6","-0.87","EURd","SWAP","PROCESSED","2024-02-01 22:22:14","","VIX","Volatility Index","",""
"52305198086073","13568.47","-0.87","EURd","SWAP","PROCESSED","2024-02-01 22:22:14","","VIX","Volatility Index","",""
"52305190738315","13569.34","-0.23","EURd","SWAP","PROCESSED","2024-02-01 22:22:07","","TSLA","Tesla Inc (Extended Hours)","",""
"52305189689103","13569.57","-0.23","EURd","SWAP","PROCESSED","2024-02-01 22:22:06","","TSLA","Tesla Inc (Extended Hours)","",""
"52305189688628","13569.8","-0.46","EURd","SWAP","PROCESSED","2024-02-01 22:22:06","","TSLA","Tesla Inc (Extended Hours)","",""
"52305189688200","13570.26","-0.23","EURd","SWAP","PROCESSED","2024-02-01 22:22:06","","TSLA","Tesla Inc (Extended Hours)","",""
"52305188639574","13570.49","-0.46","EURd","SWAP","PROCESSED","2024-02-01 22:22:05","","TSLA","Tesla Inc (Extended Hours)","",""
"52305188639103","13570.95","-0.46","EURd","SWAP","PROCESSED","2024-02-01 22:22:05","","TSLA","Tesla Inc (Extended Hours)","",""
"52305183405166","13571.41","-1.31","EURd","SWAP","PROCESSED","2024-02-01 22:22:00","","ETH/USD","Ethereum / USD","",""
"52214615801233","13572.72","-1.15","EURd","SWAP","PROCESSED","2024-01-31 22:22:28","","VIX","Volatility Index","",""
"52214614752635","13573.87","-1.15","EURd","SWAP","PROCESSED","2024-01-31 22:22:27","","VIX","Volatility Index","",""
"52214612653618","13575.02","-0.23","EURd","SWAP","PROCESSED","2024-01-31 22:22:25","","TSLA","Tesla Inc (Extended Hours)","",""
"52214611604732","13575.25","-0.23","EURd","SWAP","PROCESSED","2024-01-31 22:22:24","","TSLA","Tesla Inc (Extended Hours)","",""
"52214611604497","13575.48","-0.46","EURd","SWAP","PROCESSED","2024-01-31 22:22:24","","TSLA","Tesla Inc (Extended Hours)","",""
"52214611604270","13575.94","-0.23","EURd","SWAP","PROCESSED","2024-01-31 22:22:24","","TSLA","Tesla Inc (Extended Hours)","",""
"52214611604233","13576.17","-0.46","EURd","SWAP","PROCESSED","2024-01-31 22:22:24","","TSLA","Tesla Inc (Extended Hours)","",""
"52214610555438","13576.63","-0.46","EURd","SWAP","PROCESSED","2024-01-31 22:22:23","","TSLA","Tesla Inc (Extended Hours)","",""
"52214526669089","13577.09","-1.3","EURd","SWAP","PROCESSED","2024-01-31 22:21:03","","ETH/USD","Ethereum / USD","",""
"52205932531425","13578.39","-28.06","EURd","TRADE","PROCESSED","2024-01-31 20:04:27","00016258-0055-311e-0000-4d29001c46fd_00016258-0055-311e-0000-000080511d43","VIX","Volatility Index","",""
"52123996811249","13606.45","-0.23","EURd","SWAP","PROCESSED","2024-01-30 22:22:07","","TSLA","Tesla Inc (Extended Hours)","",""
"52123995761963","13606.68","-0.23","EURd","SWAP","PROCESSED","2024-01-30 22:22:06","","TSLA","Tesla Inc (Extended Hours)","",""
"52123995761375","13606.91","-0.45","EURd","SWAP","PROCESSED","2024-01-30 22:22:06","","TSLA","Tesla Inc (Extended Hours)","",""
"52123995760961","13607.36","-0.23","EURd","SWAP","PROCESSED","2024-01-30 22:22:06","","TSLA","Tesla Inc (Extended Hours)","",""
"52123995760904","13607.59","-0.45","EURd","SWAP","PROCESSED","2024-01-30 22:22:06","","TSLA","Tesla Inc (Extended Hours)","",""
"52123994712006","13608.04","-0.45","EURd","SWAP","PROCESSED","2024-01-30 22:22:05","","TSLA","Tesla Inc (Extended Hours)","",""
"52123959057344","13608.49","-1","EURd","SWAP","PROCESSED","2024-01-30 22:21:31","","VIX","Volatility Index","",""
"52123959057281","13609.49","-1","EURd","SWAP","PROCESSED","2024-01-30 22:21:31","","VIX","Volatility Index","",""
"52123959057219","13610.49","-1","EURd","SWAP","PROCESSED","2024-01-30 22:21:31","","VIX","Volatility Index","",""
"52123952774915","13611.49","-1.36","EURd","SWAP","PROCESSED","2024-01-30 22:21:25","","ETH/USD","Ethereum / USD","",""
"52033314913355","13612.85","-0.24","EURd","SWAP","PROCESSED","2024-01-29 22:20:46","","TSLA","Tesla Inc (Extended Hours)","",""
"52033313863254","13613.09","-0.24","EURd","SWAP","PROCESSED","2024-01-29 22:20:45","","TSLA","Tesla Inc (Extended Hours)","",""
"52033312812940","13613.33","-0.47","EURd","SWAP","PROCESSED","2024-01-29 22:20:44","","TSLA","Tesla Inc (Extended Hours)","",""
"52033311763166","13613.8","-0.24","EURd","SWAP","PROCESSED","2024-01-29 22:20:43","","TSLA","Tesla Inc (Extended Hours)","",""
"52033311763106","13614.04","-0.47","EURd","SWAP","PROCESSED","2024-01-29 22:20:43","","TSLA","Tesla Inc (Extended Hours)","",""
"52033311762620","13614.51","-0.47","EURd","SWAP","PROCESSED","2024-01-29 22:20:43","","TSLA","Tesla Inc (Extended Hours)","",""
"52033286594432","13614.98","-1.32","EURd","SWAP","PROCESSED","2024-01-29 22:20:19","","ETH/USD","Ethereum / USD","",""
"52033271911302","13616.3","-1.01","EURd","SWAP","PROCESSED","2024-01-29 22:20:05","","VIX","Volatility Index","",""
"52033271911267","13617.31","-1.01","EURd","SWAP","PROCESSED","2024-01-29 22:20:05","","VIX","Volatility Index","",""
"52033271911181","13618.32","-1.01","EURd","SWAP","PROCESSED","2024-01-29 22:20:05","","VIX","Volatility Index","",""
"51942794483627","13619.33","-0.23","EURd","SWAP","PROCESSED","2024-01-28 22:21:59","","TSLA","Tesla Inc (Extended Hours)","",""
"51942793434301","13619.56","-0.23","EURd","SWAP","PROCESSED","2024-01-28 22:21:58","","TSLA","Tesla Inc (Extended Hours)","",""
"51942793433706","13619.79","-0.45","EURd","SWAP","PROCESSED","2024-01-28 22:21:58","","TSLA","Tesla Inc (Extended Hours)","",""
"51942792384587","13620.24","-0.23","EURd","SWAP","PROCESSED","2024-01-28 22:21:57","","TSLA","Tesla Inc (Extended Hours)","",""
"51942792384532","13620.47","-0.45","EURd","SWAP","PROCESSED","2024-01-28 22:21:57","","TSLA","Tesla Inc (Extended Hours)","",""
"51942792384089","13620.92","-0.45","EURd","SWAP","PROCESSED","2024-01-28 22:21:57","","TSLA","Tesla Inc (Extended Hours)","",""
"51942723189260","13621.37","-1.1","EURd","SWAP","PROCESSED","2024-01-28 22:20:51","","VIX","Volatility Index","",""
"51942723189200","13622.47","-1.1","EURd","SWAP","PROCESSED","2024-01-28 22:20:51","","VIX","Volatility Index","",""
"51942723189150","13623.57","-1.1","EURd","SWAP","PROCESSED","2024-01-28 22:20:51","","VIX","Volatility Index","",""
"51942708505081","13624.67","-1.29","EURd","SWAP","PROCESSED","2024-01-28 22:20:37","","ETH/USD","Ethereum / USD","",""
"51852194374657","13625.96","-0.23","EURd","SWAP","PROCESSED","2024-01-27 22:21:56","","TSLA","Tesla Inc (Extended Hours)","",""
"51852192274924","13626.19","-0.23","EURd","SWAP","PROCESSED","2024-01-27 22:21:54","","TSLA","Tesla Inc (Extended Hours)","",""
"51852192274274","13626.42","-0.45","EURd","SWAP","PROCESSED","2024-01-27 22:21:54","","TSLA","Tesla Inc (Extended Hours)","",""
"51852190174470","13626.87","-0.23","EURd","SWAP","PROCESSED","2024-01-27 22:21:52","","TSLA","Tesla Inc (Extended Hours)","",""
"51852190174401","13627.1","-0.45","EURd","SWAP","PROCESSED","2024-01-27 22:21:52","","TSLA","Tesla Inc (Extended Hours)","",""
"51852190173968","13627.55","-0.45","EURd","SWAP","PROCESSED","2024-01-27 22:21:52","","TSLA","Tesla Inc (Extended Hours)","",""
"51852157669696","13628","-1.1","EURd","SWAP","PROCESSED","2024-01-27 22:21:21","","VIX","Volatility Index","",""
"51852157669634","13629.1","-1.1","EURd","SWAP","PROCESSED","2024-01-27 22:21:21","","VIX","Volatility Index","",""
"51852157669567","13630.2","-1.1","EURd","SWAP","PROCESSED","2024-01-27 22:21:21","","VIX","Volatility Index","",""
"51852090562187","13631.3","-1.29","EURd","SWAP","PROCESSED","2024-01-27 22:20:17","","ETH/USD","Ethereum / USD","",""
"51761556520063","13632.59","-0.23","EURd","SWAP","PROCESSED","2024-01-26 22:21:17","","TSLA","Tesla Inc (Extended Hours)","",""
"51761556519197","13632.82","-0.23","EURd","SWAP","PROCESSED","2024-01-26 22:21:17","","TSLA","Tesla Inc (Extended Hours)","",""
"51761555469891","13633.05","-0.45","EURd","SWAP","PROCESSED","2024-01-26 22:21:16","","TSLA","Tesla Inc (Extended Hours)","",""
"51761555469285","13633.5","-0.23","EURd","SWAP","PROCESSED","2024-01-26 22:21:16","","TSLA","Tesla Inc (Extended Hours)","",""
"51761555469152","13633.73","-0.45","EURd","SWAP","PROCESSED","2024-01-26 22:21:16","","TSLA","Tesla Inc (Extended Hours)","",""
"51761555468760","13634.18","-0.45","EURd","SWAP","PROCESSED","2024-01-26 22:21:16","","TSLA","Tesla Inc (Extended Hours)","",""
"51761518765658","13634.63","-1.29","EURd","SWAP","PROCESSED","2024-01-26 22:20:41","","ETH/USD","Ethereum / USD","",""
"51761499882481","13635.92","-1.1","EURd","SWAP","PROCESSED","2024-01-26 22:20:23","","VIX","Volatility Index","",""
"51761499882393","13637.02","-1.1","EURd","SWAP","PROCESSED","2024-01-26 22:20:23","","VIX","Volatility Index","",""
"51761499882339","13638.12","-1.1","EURd","SWAP","PROCESSED","2024-01-26 22:20:23","","VIX","Volatility Index","",""
"51670986815270","13639.22","-1.26","EURd","SWAP","PROCESSED","2024-01-25 22:21:43","","ETH/USD","Ethereum / USD","",""
"51670974231550","13640.48","-0.23","EURd","SWAP","PROCESSED","2024-01-25 22:21:31","","TSLA","Tesla Inc (Extended Hours)","",""
"51670974230707","13640.71","-0.23","EURd","SWAP","PROCESSED","2024-01-25 22:21:31","","TSLA","Tesla Inc (Extended Hours)","",""
"51670973181289","13640.94","-0.45","EURd","SWAP","PROCESSED","2024-01-25 22:21:30","","TSLA","Tesla Inc (Extended Hours)","",""
"51670973180656","13641.39","-0.23","EURd","SWAP","PROCESSED","2024-01-25 22:21:30","","TSLA","Tesla Inc (Extended Hours)","",""
"51670973180541","13641.62","-0.45","EURd","SWAP","PROCESSED","2024-01-25 22:21:30","","TSLA","Tesla Inc (Extended Hours)","",""
"51670972131448","13642.07","-0.45","EURd","SWAP","PROCESSED","2024-01-25 22:21:29","","TSLA","Tesla Inc (Extended Hours)","",""
"51670951162397","13642.52","-1.14","EURd","SWAP","PROCESSED","2024-01-25 22:21:09","","VIX","Volatility Index","",""
"51670951162335","13643.66","-1.14","EURd","SWAP","PROCESSED","2024-01-25 22:21:09","","VIX","Volatility Index","",""
"51670951162297","13644.8","-1.14","EURd","SWAP","PROCESSED","2024-01-25 22:21:09","","VIX","Volatility Index","",""
"51580418148128","13645.94","-0.25","EURd","SWAP","PROCESSED","2024-01-24 22:22:10","","TSLA","Tesla Inc (Extended Hours)","",""
"51580417098879","13646.19","-0.25","EURd","SWAP","PROCESSED","2024-01-24 22:22:09","","TSLA","Tesla Inc (Extended Hours)","",""
"51580417098270","13646.44","-0.49","EURd","SWAP","PROCESSED","2024-01-24 22:22:09","","TSLA","Tesla Inc (Extended Hours)","",""
"51580417097750","13646.93","-0.25","EURd","SWAP","PROCESSED","2024-01-24 22:22:09","","TSLA","Tesla Inc (Extended Hours)","",""
"51580417114023","13647.18","-0.49","EURd","SWAP","PROCESSED","2024-01-24 22:22:09","","TSLA","Tesla Inc (Extended Hours)","",""
"51580416065057","13647.67","-0.49","EURd","SWAP","PROCESSED","2024-01-24 22:22:08","","TSLA","Tesla Inc (Extended Hours)","",""
"51580317493141","13648.16","-1.26","EURd","SWAP","PROCESSED","2024-01-24 22:20:34","","ETH/USD","Ethereum / USD","",""
"51580293376363","13649.42","-1.14","EURd","SWAP","PROCESSED","2024-01-24 22:20:11","","VIX","Volatility Index","",""
"51580293376294","13650.56","-1.14","EURd","SWAP","PROCESSED","2024-01-24 22:20:11","","VIX","Volatility Index","",""
"51580293376164","13651.7","-1.14","EURd","SWAP","PROCESSED","2024-01-24 22:20:11","","VIX","Volatility Index","",""
"51489824338933","13652.84","-0.26","EURd","SWAP","PROCESSED","2024-01-23 22:22:13","","TSLA","Tesla Inc (Extended Hours)","",""
"51489823289349","13653.1","-0.26","EURd","SWAP","PROCESSED","2024-01-23 22:22:12","","TSLA","Tesla Inc (Extended Hours)","",""
"51489823288679","13653.36","-0.51","EURd","SWAP","PROCESSED","2024-01-23 22:22:12","","TSLA","Tesla Inc (Extended Hours)","",""
"51489822239698","13653.87","-0.26","EURd","SWAP","PROCESSED","2024-01-23 22:22:11","","TSLA","Tesla Inc (Extended Hours)","",""
"51489822239609","13654.13","-0.51","EURd","SWAP","PROCESSED","2024-01-23 22:22:11","","TSLA","Tesla Inc (Extended Hours)","",""
"51489822239345","13654.64","-0.51","EURd","SWAP","PROCESSED","2024-01-23 22:22:11","","TSLA","Tesla Inc (Extended Hours)","",""
"51489763517297","13655.15","-1.14","EURd","SWAP","PROCESSED","2024-01-23 22:21:15","","VIX","Volatility Index","",""
"51489763517230","13656.29","-1.14","EURd","SWAP","PROCESSED","2024-01-23 22:21:15","","VIX","Volatility Index","",""
"51489763517105","13657.43","-1.14","EURd","SWAP","PROCESSED","2024-01-23 22:21:15","","VIX","Volatility Index","",""
"51489707945584","13658.57","-1.26","EURd","SWAP","PROCESSED","2024-01-23 22:20:22","","ETH/USD","Ethereum / USD","",""
"51399222117305","13659.83","-0.26","EURd","SWAP","PROCESSED","2024-01-22 22:22:08","","TSLA","Tesla Inc (Extended Hours)","",""
"51399221083864","13660.09","-0.26","EURd","SWAP","PROCESSED","2024-01-22 22:22:07","","TSLA","Tesla Inc (Extended Hours)","",""
"51399220034534","13660.35","-0.51","EURd","SWAP","PROCESSED","2024-01-22 22:22:06","","TSLA","Tesla Inc (Extended Hours)","",""
"51399220033979","13660.86","-0.26","EURd","SWAP","PROCESSED","2024-01-22 22:22:06","","TSLA","Tesla Inc (Extended Hours)","",""
"51399220033866","13661.12","-0.51","EURd","SWAP","PROCESSED","2024-01-22 22:22:06","","TSLA","Tesla Inc (Extended Hours)","",""
"51399218984975","13661.63","-0.51","EURd","SWAP","PROCESSED","2024-01-22 22:22:05","","TSLA","Tesla Inc (Extended Hours)","",""
"51399160259547","13662.14","-1.14","EURd","SWAP","PROCESSED","2024-01-22 22:21:09","","VIX","Volatility Index","",""
"51399160259494","13663.28","-1.14","EURd","SWAP","PROCESSED","2024-01-22 22:21:09","","VIX","Volatility Index","",""
"51399159210807","13664.42","-1.14","EURd","SWAP","PROCESSED","2024-01-22 22:21:08","","VIX","Volatility Index","",""
"51399098388618","13665.56","-1.32","EURd","SWAP","PROCESSED","2024-01-22 22:20:10","","ETH/USD","Ethereum / USD","",""
"51364118950969","13666.88","23.51","EURd","TRADE","PROCESSED","2024-01-22 13:04:11","0024e503-0055-311e-0000-4d200001c4af_0024e503-0055-311e-0000-0000802707fc","INTC","Intel Corp (Extended Hours)","",""
"51364118950968","13643.37","-8.45","EURd","TRADE","PROCESSED","2024-01-22 13:04:11","0024e503-0055-311e-0000-4d200001c4ae_0024e503-0055-311e-0000-0000802704b8","INTC","Intel Corp (Extended Hours)","",""
"51308629349439","13651.82","-0.26","EURd","SWAP","PROCESSED","2024-01-21 22:22:12","","TSLA","Tesla Inc (Extended Hours)","",""
"51308628299740","13652.08","-0.26","EURd","SWAP","PROCESSED","2024-01-21 22:22:11","","TSLA","Tesla Inc (Extended Hours)","",""
"51308627250538","13652.34","-0.51","EURd","SWAP","PROCESSED","2024-01-21 22:22:10","","TSLA","Tesla Inc (Extended Hours)","",""
"51308627250068","13652.85","-0.26","EURd","SWAP","PROCESSED","2024-01-21 22:22:10","","TSLA","Tesla Inc (Extended Hours)","",""
"51308627250005","13653.11","-0.51","EURd","SWAP","PROCESSED","2024-01-21 22:22:10","","TSLA","Tesla Inc (Extended Hours)","",""
"51308627249691","13653.62","-0.51","EURd","SWAP","PROCESSED","2024-01-21 22:22:10","","TSLA","Tesla Inc (Extended Hours)","",""
"51308564343664","13654.13","-0.24","EURd","SWAP","PROCESSED","2024-01-21 22:21:10","","INTC","Intel Corp (Extended Hours)","",""
"51308564343524","13654.37","-0.24","EURd","SWAP","PROCESSED","2024-01-21 22:21:10","","INTC","Intel Corp (Extended Hours)","",""
"51308533925529","13654.61","-1.09","EURd","SWAP","PROCESSED","2024-01-21 22:20:41","","VIX","Volatility Index","",""
"51308533925485","13655.7","-1.09","EURd","SWAP","PROCESSED","2024-01-21 22:20:41","","VIX","Volatility Index","",""
"51308533925344","13656.79","-1.09","EURd","SWAP","PROCESSED","2024-01-21 22:20:41","","VIX","Volatility Index","",""
"51218030280888","13657.88","-0.26","EURd","SWAP","PROCESSED","2024-01-20 22:22:10","","TSLA","Tesla Inc (Extended Hours)","",""
"51218029247556","13658.14","-0.26","EURd","SWAP","PROCESSED","2024-01-20 22:22:09","","TSLA","Tesla Inc (Extended Hours)","",""
"51218029246940","13658.4","-0.51","EURd","SWAP","PROCESSED","2024-01-20 22:22:09","","TSLA","Tesla Inc (Extended Hours)","",""
"51218028197776","13658.91","-0.26","EURd","SWAP","PROCESSED","2024-01-20 22:22:08","","TSLA","Tesla Inc (Extended Hours)","",""
"51218028197687","13659.17","-0.51","EURd","SWAP","PROCESSED","2024-01-20 22:22:08","","TSLA","Tesla Inc (Extended Hours)","",""
"51218028197382","13659.68","-0.51","EURd","SWAP","PROCESSED","2024-01-20 22:22:08","","TSLA","Tesla Inc (Extended Hours)","",""
"51217949555416","13660.19","-0.24","EURd","SWAP","PROCESSED","2024-01-20 22:20:53","","INTC","Intel Corp (Extended Hours)","",""
"51217949555301","13660.43","-0.24","EURd","SWAP","PROCESSED","2024-01-20 22:20:53","","INTC","Intel Corp (Extended Hours)","",""
"51217917036563","13660.67","-1.09","EURd","SWAP","PROCESSED","2024-01-20 22:20:22","","VIX","Volatility Index","",""
"51217917036511","13661.76","-1.09","EURd","SWAP","PROCESSED","2024-01-20 22:20:22","","VIX","Volatility Index","",""
"51217917036367","13662.85","-1.09","EURd","SWAP","PROCESSED","2024-01-20 22:20:22","","VIX","Volatility Index","",""
"51127431217267","13663.94","-0.26","EURd","SWAP","PROCESSED","2024-01-19 22:22:08","","TSLA","Tesla Inc (Extended Hours)","",""
"51127430183808","13664.2","-0.26","EURd","SWAP","PROCESSED","2024-01-19 22:22:07","","TSLA","Tesla Inc (Extended Hours)","",""
"51127429134588","13664.46","-0.51","EURd","SWAP","PROCESSED","2024-01-19 22:22:06","","TSLA","Tesla Inc (Extended Hours)","",""
"51127429133920","13664.97","-0.26","EURd","SWAP","PROCESSED","2024-01-19 22:22:06","","TSLA","Tesla Inc (Extended Hours)","",""
"51127429133830","13665.23","-0.51","EURd","SWAP","PROCESSED","2024-01-19 22:22:06","","TSLA","Tesla Inc (Extended Hours)","",""
"51127428084906","13665.74","-0.51","EURd","SWAP","PROCESSED","2024-01-19 22:22:05","","TSLA","Tesla Inc (Extended Hours)","",""
"51127334756680","13666.25","-0.24","EURd","SWAP","PROCESSED","2024-01-19 22:20:36","","INTC","Intel Corp (Extended Hours)","",""
"51127334756570","13666.49","-0.24","EURd","SWAP","PROCESSED","2024-01-19 22:20:36","","INTC","Intel Corp (Extended Hours)","",""
"51127326371558","13666.73","-1.09","EURd","SWAP","PROCESSED","2024-01-19 22:20:28","","VIX","Volatility Index","",""
"51127326371520","13667.82","-1.09","EURd","SWAP","PROCESSED","2024-01-19 22:20:28","","VIX","Volatility Index","",""
"51127325322828","13668.91","-1.09","EURd","SWAP","PROCESSED","2024-01-19 22:20:27","","VIX","Volatility Index","",""
"51036839497360","13670","-0.26","EURd","SWAP","PROCESSED","2024-01-18 22:22:13","","TSLA","Tesla Inc (Extended Hours)","",""
"51036838447752","13670.26","-0.26","EURd","SWAP","PROCESSED","2024-01-18 22:22:12","","TSLA","Tesla Inc (Extended Hours)","",""
"51036838447080","13670.52","-0.51","EURd","SWAP","PROCESSED","2024-01-18 22:22:12","","TSLA","Tesla Inc (Extended Hours)","",""
"51036837397906","13671.03","-0.26","EURd","SWAP","PROCESSED","2024-01-18 22:22:11","","TSLA","Tesla Inc (Extended Hours)","",""
"51036837397830","13671.29","-0.51","EURd","SWAP","PROCESSED","2024-01-18 22:22:11","","TSLA","Tesla Inc (Extended Hours)","",""
"51036837397521","13671.8","-0.51","EURd","SWAP","PROCESSED","2024-01-18 22:22:11","","TSLA","Tesla Inc (Extended Hours)","",""
"51036821682982","13672.31","-0.23","EURd","SWAP","PROCESSED","2024-01-18 22:21:56","","INTC","Intel Corp (Extended Hours)","",""
"51036821682857","13672.54","-0.23","EURd","SWAP","PROCESSED","2024-01-18 22:21:56","","INTC","Intel Corp (Extended Hours)","",""
"51036759806579","13672.77","-0.99","EURd","SWAP","PROCESSED","2024-01-18 22:20:57","","VIX","Volatility Index","",""
"51036759806492","13673.76","-0.99","EURd","SWAP","PROCESSED","2024-01-18 22:20:57","","VIX","Volatility Index","",""
"51036759806369","13674.75","-0.99","EURd","SWAP","PROCESSED","2024-01-18 22:20:57","","VIX","Volatility Index","",""
"50946168078616","13675.74","-0.27","EURd","SWAP","PROCESSED","2024-01-17 22:21:02","","TSLA","Tesla Inc (Extended Hours)","",""
"50946165995930","13676.01","-0.27","EURd","SWAP","PROCESSED","2024-01-17 22:21:00","","TSLA","Tesla Inc (Extended Hours)","",""
"50946165994727","13676.28","-0.52","EURd","SWAP","PROCESSED","2024-01-17 22:21:00","","TSLA","Tesla Inc (Extended Hours)","",""
"50946164945086","13676.8","-0.27","EURd","SWAP","PROCESSED","2024-01-17 22:20:59","","TSLA","Tesla Inc (Extended Hours)","",""
"50946164944903","13677.07","-0.52","EURd","SWAP","PROCESSED","2024-01-17 22:20:59","","TSLA","Tesla Inc (Extended Hours)","",""
"50946163895855","13677.59","-0.52","EURd","SWAP","PROCESSED","2024-01-17 22:20:58","","TSLA","Tesla Inc (Extended Hours)","",""
"50946121941446","13678.11","-0.23","EURd","SWAP","PROCESSED","2024-01-17 22:20:18","","INTC","Intel Corp (Extended Hours)","",""
"50946121941315","13678.34","-0.23","EURd","SWAP","PROCESSED","2024-01-17 22:20:18","","INTC","Intel Corp (Extended Hours)","",""
"50946114606567","13678.57","-0.97","EURd","SWAP","PROCESSED","2024-01-17 22:20:11","","VIX","Volatility Index","",""
"50946114606510","13679.54","-0.97","EURd","SWAP","PROCESSED","2024-01-17 22:20:11","","VIX","Volatility Index","",""
"50946113557780","13680.51","-0.97","EURd","SWAP","PROCESSED","2024-01-17 22:20:10","","VIX","Volatility Index","",""
"50855638234295","13681.48","-0.27","EURd","SWAP","PROCESSED","2024-01-16 22:22:06","","TSLA","Tesla Inc (Extended Hours)","",""
"50855637184620","13681.75","-0.53","EURd","SWAP","PROCESSED","2024-01-16 22:22:05","","TSLA","Tesla Inc (Extended Hours)","",""
"50855636135186","13682.28","-0.27","EURd","SWAP","PROCESSED","2024-01-16 22:22:04","","TSLA","Tesla Inc (Extended Hours)","",""
"50855636135039","13682.55","-0.53","EURd","SWAP","PROCESSED","2024-01-16 22:22:04","","TSLA","Tesla Inc (Extended Hours)","",""
"50855636134582","13683.08","-0.53","EURd","SWAP","PROCESSED","2024-01-16 22:22:04","","TSLA","Tesla Inc (Extended Hours)","",""
"50855527074275","13683.61","-0.23","EURd","SWAP","PROCESSED","2024-01-16 22:20:20","","INTC","Intel Corp (Extended Hours)","",""
"50855527074166","13683.84","-0.23","EURd","SWAP","PROCESSED","2024-01-16 22:20:20","","INTC","Intel Corp (Extended Hours)","",""
"50855518689409","13684.07","-0.94","EURd","SWAP","PROCESSED","2024-01-16 22:20:12","","VIX","Volatility Index","",""
"50855518689349","13685.01","-0.94","EURd","SWAP","PROCESSED","2024-01-16 22:20:12","","VIX","Volatility Index","",""
"50855518689238","13685.95","-0.94","EURd","SWAP","PROCESSED","2024-01-16 22:20:12","","VIX","Volatility Index","",""
"50843032246333","13686.89","-10.21","EURd","TRADE","PROCESSED","2024-01-16 19:01:44","00016258-0055-311e-0000-4d1a001afe16_00016258-0055-311e-0000-000080512a6d","VIX","Volatility Index","",""
"50843030149157","13697.1","-19.59","EURd","TRADE","PROCESSED","2024-01-16 19:01:42","00016258-0055-311e-0000-4d1a001afdcd_00016258-0055-311e-0000-000080512777","VIX","Volatility Index","",""
"50765055950625","13716.69","-0.26","EURd","SWAP","PROCESSED","2024-01-15 22:22:20","","TSLA","Tesla Inc (Extended Hours)","",""
"50765054901463","13716.95","-0.53","EURd","SWAP","PROCESSED","2024-01-15 22:22:19","","TSLA","Tesla Inc (Extended Hours)","",""
"50765053852355","13717.48","-0.26","EURd","SWAP","PROCESSED","2024-01-15 22:22:18","","TSLA","Tesla Inc (Extended Hours)","",""
"50765053852271","13717.74","-0.53","EURd","SWAP","PROCESSED","2024-01-15 22:22:18","","TSLA","Tesla Inc (Extended Hours)","",""
"50765053852040","13718.27","-0.53","EURd","SWAP","PROCESSED","2024-01-15 22:22:18","","TSLA","Tesla Inc (Extended Hours)","",""
"50764977298918","13718.8","-0.23","EURd","SWAP","PROCESSED","2024-01-15 22:21:05","","INTC","Intel Corp (Extended Hours)","",""
"50764977298787","13719.03","-0.23","EURd","SWAP","PROCESSED","2024-01-15 22:21:05","","INTC","Intel Corp (Extended Hours)","",""
"50764955280289","13719.26","-1.27","EURd","SWAP","PROCESSED","2024-01-15 22:20:44","","VIX","Volatility Index","",""
"50764955280233","13720.53","-1.27","EURd","SWAP","PROCESSED","2024-01-15 22:20:44","","VIX","Volatility Index","",""
"50764955280130","13721.8","-1.27","EURd","SWAP","PROCESSED","2024-01-15 22:20:44","","VIX","Volatility Index","",""
"50764954231480","13723.07","-1.27","EURd","SWAP","PROCESSED","2024-01-15 22:20:43","","VIX","Volatility Index","",""
"50764954231354","13724.34","-1.27","EURd","SWAP","PROCESSED","2024-01-15 22:20:43","","VIX","Volatility Index","",""
"50674425425242","13725.61","-0.26","EURd","SWAP","PROCESSED","2024-01-14 22:21:48","","TSLA","Tesla Inc (Extended Hours)","",""
"50674424375134","13725.87","-0.53","EURd","SWAP","PROCESSED","2024-01-14 22:21:47","","TSLA","Tesla Inc (Extended Hours)","",""
"50674424373900","13726.4","-0.26","EURd","SWAP","PROCESSED","2024-01-14 22:21:47","","TSLA","Tesla Inc (Extended Hours)","",""
"50674423325125","13726.66","-0.53","EURd","SWAP","PROCESSED","2024-01-14 22:21:46","","TSLA","Tesla Inc (Extended Hours)","",""
"50674423324565","13727.19","-0.53","EURd","SWAP","PROCESSED","2024-01-14 22:21:46","","TSLA","Tesla Inc (Extended Hours)","",""
"50674346779004","13727.72","-1.22","EURd","SWAP","PROCESSED","2024-01-14 22:20:33","","VIX","Volatility Index","",""
"50674346778937","13728.94","-1.22","EURd","SWAP","PROCESSED","2024-01-14 22:20:33","","VIX","Volatility Index","",""
"50674346778809","13730.16","-1.22","EURd","SWAP","PROCESSED","2024-01-14 22:20:33","","VIX","Volatility Index","",""
"50674346778753","13731.38","-1.22","EURd","SWAP","PROCESSED","2024-01-14 22:20:33","","VIX","Volatility Index","",""
"50674346778637","13732.6","-1.22","EURd","SWAP","PROCESSED","2024-01-14 22:20:33","","VIX","Volatility Index","",""
"50674337343371","13733.82","-0.23","EURd","SWAP","PROCESSED","2024-01-14 22:20:24","","INTC","Intel Corp (Extended Hours)","",""
"50674337343252","13734.05","-0.23","EURd","SWAP","PROCESSED","2024-01-14 22:20:23","","INTC","Intel Corp (Extended Hours)","",""
"50583830546629","13734.28","-0.26","EURd","SWAP","PROCESSED","2024-01-13 22:21:50","","TSLA","Tesla Inc (Extended Hours)","",""
"50583829496473","13734.54","-0.53","EURd","SWAP","PROCESSED","2024-01-13 22:21:49","","TSLA","Tesla Inc (Extended Hours)","",""
"50583828463096","13735.07","-0.26","EURd","SWAP","PROCESSED","2024-01-13 22:21:48","","TSLA","Tesla Inc (Extended Hours)","",""
"50583828462917","13735.33","-0.53","EURd","SWAP","PROCESSED","2024-01-13 22:21:48","","TSLA","Tesla Inc (Extended Hours)","",""
"50583828462333","13735.86","-0.53","EURd","SWAP","PROCESSED","2024-01-13 22:21:48","","TSLA","Tesla Inc (Extended Hours)","",""
"50583739333983","13736.39","-1.22","EURd","SWAP","PROCESSED","2024-01-13 22:20:23","","VIX","Volatility Index","",""
"50583739333954","13737.61","-1.22","EURd","SWAP","PROCESSED","2024-01-13 22:20:23","","VIX","Volatility Index","",""
"50583739333834","13738.83","-1.22","EURd","SWAP","PROCESSED","2024-01-13 22:20:23","","VIX","Volatility Index","",""
"50583739333767","13740.05","-1.22","EURd","SWAP","PROCESSED","2024-01-13 22:20:23","","VIX","Volatility Index","",""
"50583739333646","13741.27","-1.22","EURd","SWAP","PROCESSED","2024-01-13 22:20:23","","VIX","Volatility Index","",""
"50583716265547","13742.49","-0.23","EURd","SWAP","PROCESSED","2024-01-13 22:20:01","","INTC","Intel Corp (Extended Hours)","",""
"50583716265356","13742.72","-0.23","EURd","SWAP","PROCESSED","2024-01-13 22:20:01","","INTC","Intel Corp (Extended Hours)","",""
"50493249315790","13742.95","-0.26","EURd","SWAP","PROCESSED","2024-01-12 22:22:05","","TSLA","Tesla Inc (Extended Hours)","",""
"50493248266018","13743.21","-0.53","EURd","SWAP","PROCESSED","2024-01-12 22:22:04","","TSLA","Tesla Inc (Extended Hours)","",""
"50493247216494","13743.74","-0.26","EURd","SWAP","PROCESSED","2024-01-12 22:22:03","","TSLA","Tesla Inc (Extended Hours)","",""
"50493247216353","13744","-0.53","EURd","SWAP","PROCESSED","2024-01-12 22:22:03","","TSLA","Tesla Inc (Extended Hours)","",""
"50493247215844","13744.53","-0.53","EURd","SWAP","PROCESSED","2024-01-12 22:22:03","","TSLA","Tesla Inc (Extended Hours)","",""
"50493215766466","13745.06","-0.23","EURd","SWAP","PROCESSED","2024-01-12 22:21:33","","INTC","Intel Corp (Extended Hours)","",""
"50493214717723","13745.29","-0.23","EURd","SWAP","PROCESSED","2024-01-12 22:21:32","","INTC","Intel Corp (Extended Hours)","",""
"50493148659507","13745.52","-1.22","EURd","SWAP","PROCESSED","2024-01-12 22:20:29","","VIX","Volatility Index","",""
"50493148659414","13746.74","-1.22","EURd","SWAP","PROCESSED","2024-01-12 22:20:29","","VIX","Volatility Index","",""
"50493148659310","13747.96","-1.22","EURd","SWAP","PROCESSED","2024-01-12 22:20:29","","VIX","Volatility Index","",""
"50493148659239","13749.18","-1.22","EURd","SWAP","PROCESSED","2024-01-12 22:20:29","","VIX","Volatility Index","",""
"50493148659149","13750.4","-1.22","EURd","SWAP","PROCESSED","2024-01-12 22:20:29","","VIX","Volatility Index","",""
"50402649210879","13751.62","-0.27","EURd","SWAP","PROCESSED","2024-01-11 22:22:02","","TSLA","Tesla Inc (Extended Hours)","",""
"50402648160818","13751.89","-0.55","EURd","SWAP","PROCESSED","2024-01-11 22:22:01","","TSLA","Tesla Inc (Extended Hours)","",""
"50402647111061","13752.44","-0.27","EURd","SWAP","PROCESSED","2024-01-11 22:22:00","","TSLA","Tesla Inc (Extended Hours)","",""
"50402647110911","13752.71","-0.55","EURd","SWAP","PROCESSED","2024-01-11 22:22:00","","TSLA","Tesla Inc (Extended Hours)","",""
"50402647110345","13753.26","-0.55","EURd","SWAP","PROCESSED","2024-01-11 22:22:00","","TSLA","Tesla Inc (Extended Hours)","",""
"50402615655338","13753.81","-0.99","EURd","SWAP","PROCESSED","2024-01-11 22:21:30","","VIX","Volatility Index","",""
"50402614606691","13754.8","-0.99","EURd","SWAP","PROCESSED","2024-01-11 22:21:29","","VIX","Volatility Index","",""
"50402614606567","13755.79","-0.99","EURd","SWAP","PROCESSED","2024-01-11 22:21:29","","VIX","Volatility Index","",""
"50402614606506","13756.78","-0.99","EURd","SWAP","PROCESSED","2024-01-11 22:21:29","","VIX","Volatility Index","",""
"50402614606380","13757.77","-0.99","EURd","SWAP","PROCESSED","2024-01-11 22:21:29","","VIX","Volatility Index","",""
"50402575802257","13758.76","-0.23","EURd","SWAP","PROCESSED","2024-01-11 22:20:52","","INTC","Intel Corp (Extended Hours)","",""
"50402575802154","13758.99","-0.23","EURd","SWAP","PROCESSED","2024-01-11 22:20:52","","INTC","Intel Corp (Extended Hours)","",""
"50363868665956","13759.22","8.56","EURd","TRADE","PROCESSED","2024-01-11 12:05:38","00081081-0055-311e-0000-4d150000dc33_00081081-0055-311e-0000-000080280c37","BABA","Alibaba Group Holding Limited (Extended Hours)","",""
"50363868665955","13750.66","5.56","EURd","TRADE","PROCESSED","2024-01-11 12:05:38","00081081-0055-311e-0000-4d150000dc32_00081081-0055-311e-0000-000080280ba1","BABA","Alibaba Group Holding Limited (Extended Hours)","",""
"50312049095940","13745.1","-0.17","EURd","SWAP","PROCESSED","2024-01-10 22:21:59","","BABA","Alibaba Group Holding Limited (Extended Hours)","",""
"50312049095874","13745.27","-0.09","EURd","SWAP","PROCESSED","2024-01-10 22:21:59","","BABA","Alibaba Group Holding Limited (Extended Hours)","",""
"50312045945872","13745.36","-0.86","EURd","SWAP","PROCESSED","2024-01-10 22:21:56","","VIX","Volatility Index","",""
"50312045945803","13746.22","-0.86","EURd","SWAP","PROCESSED","2024-01-10 22:21:56","","VIX","Volatility Index","",""
"50312045945705","13747.08","-0.86","EURd","SWAP","PROCESSED","2024-01-10 22:21:56","","VIX","Volatility Index","",""
"50312045945630","13747.94","-0.86","EURd","SWAP","PROCESSED","2024-01-10 22:21:56","","VIX","Volatility Index","",""
"50312045945515","13748.8","-0.86","EURd","SWAP","PROCESSED","2024-01-10 22:21:56","","VIX","Volatility Index","",""
"50312037561664","13749.66","-0.56","EURd","SWAP","PROCESSED","2024-01-10 22:21:48","","TSLA","Tesla Inc (Extended Hours)","",""
"50312036511468","13750.22","-0.28","EURd","SWAP","PROCESSED","2024-01-10 22:21:47","","TSLA","Tesla Inc (Extended Hours)","",""
"50312036511308","13750.5","-0.56","EURd","SWAP","PROCESSED","2024-01-10 22:21:47","","TSLA","Tesla Inc (Extended Hours)","",""
"50312035461976","13751.06","-0.56","EURd","SWAP","PROCESSED","2024-01-10 22:21:46","","TSLA","Tesla Inc (Extended Hours)","",""
"50311928506831","13751.62","-0.23","EURd","SWAP","PROCESSED","2024-01-10 22:20:04","","INTC","Intel Corp (Extended Hours)","",""
"50311927457850","13751.85","-0.23","EURd","SWAP","PROCESSED","2024-01-10 22:20:03","","INTC","Intel Corp (Extended Hours)","",""
"50302327747572","13752.08","13.72","EURd","TRADE","PROCESSED","2024-01-10 19:47:28","000940dd-0055-311e-0000-4d14000cba94_000940dd-0055-311e-0000-000081bb559f","BTC/USD","Bitcoin / USD","",""
"50273841078084","13738.36","117.93","EURd","TRADE","PROCESSED","2024-01-10 12:14:41","0015421d-0055-311e-0000-4d14000668de_0015421d-0055-311e-0000-000080ee5605","ETH/USD","Ethereum / USD","",""
"50221435341622","13620.43","-0.57","EURd","SWAP","PROCESSED","2024-01-09 22:21:43","","TSLA","Tesla Inc (Extended Hours)","",""
"50221434291423","13621","-0.28","EURd","SWAP","PROCESSED","2024-01-09 22:21:42","","TSLA","Tesla Inc (Extended Hours)","",""
"50221434291236","13621.28","-0.57","EURd","SWAP","PROCESSED","2024-01-09 22:21:42","","TSLA","Tesla Inc (Extended Hours)","",""
"50221433241824","13621.85","-0.57","EURd","SWAP","PROCESSED","2024-01-09 22:21:41","","TSLA","Tesla Inc (Extended Hours)","",""
"50221415422790","13622.42","-1.34","EURd","SWAP","PROCESSED","2024-01-09 22:21:24","","ETH/USD","Ethereum / USD","",""
"50221387120636","13623.76","-0.09","EURd","SWAP","PROCESSED","2024-01-09 22:20:57","","BABA","Alibaba Group Holding Limited (Extended Hours)","",""
"50221379770405","13623.85","-0.86","EURd","SWAP","PROCESSED","2024-01-09 22:20:50","","VIX","Volatility Index","",""
"50221378721766","13624.71","-0.86","EURd","SWAP","PROCESSED","2024-01-09 22:20:49","","VIX","Volatility Index","",""
"50221378721645","13625.57","-0.86","EURd","SWAP","PROCESSED","2024-01-09 22:20:49","","VIX","Volatility Index","",""
"50221378721592","13626.43","-0.86","EURd","SWAP","PROCESSED","2024-01-09 22:20:49","","VIX","Volatility Index","",""
"50221378721483","13627.29","-0.86","EURd","SWAP","PROCESSED","2024-01-09 22:20:49","","VIX","Volatility Index","",""
"50221373487052","13628.15","-0.24","EURd","SWAP","PROCESSED","2024-01-09 22:20:44","","INTC","Intel Corp (Extended Hours)","",""
"50191996579629","13628.39","-6.3","EURd","TRADE","PROCESSED","2024-01-09 14:33:48","00016258-0055-311e-0000-4d130009f0c4_00016258-0055-311e-0000-000080520682","VIX","Volatility Index","",""
"50191967219242","13634.69","36.72","EURd","TRADE","PROCESSED","2024-01-09 14:33:20","00018387-0055-311e-0000-4d130009e753_00018387-0055-311e-0000-000080ef69a9","Natural Gas","Natural Gas","",""
"50191967219241","13597.97","22.74","EURd","TRADE","PROCESSED","2024-01-09 14:33:20","00018387-0055-311e-0000-4d130009e752_00018387-0055-311e-0000-000080ef33ef","Natural Gas","Natural Gas","",""
"50130828935196","13575.23","-0.57","EURd","SWAP","PROCESSED","2024-01-08 22:21:34","","TSLA","Tesla Inc (Extended Hours)","",""
"50130827901229","13575.8","-0.29","EURd","SWAP","PROCESSED","2024-01-08 22:21:33","","TSLA","Tesla Inc (Extended Hours)","",""
"50130827901033","13576.09","-0.57","EURd","SWAP","PROCESSED","2024-01-08 22:21:33","","TSLA","Tesla Inc (Extended Hours)","",""
"50130827900174","13576.66","-0.57","EURd","SWAP","PROCESSED","2024-01-08 22:21:33","","TSLA","Tesla Inc (Extended Hours)","",""
"50130783862611","13577.23","-0.86","EURd","SWAP","PROCESSED","2024-01-08 22:20:51","","VIX","Volatility Index","",""
"50130782813768","13578.09","-0.86","EURd","SWAP","PROCESSED","2024-01-08 22:20:50","","VIX","Volatility Index","",""
"50130782813684","13578.95","-0.86","EURd","SWAP","PROCESSED","2024-01-08 22:20:50","","VIX","Volatility Index","",""
"50130782813563","13579.81","-0.86","EURd","SWAP","PROCESSED","2024-01-08 22:20:50","","VIX","Volatility Index","",""
"50130782813513","13580.67","-0.86","EURd","SWAP","PROCESSED","2024-01-08 22:20:50","","VIX","Volatility Index","",""
"50130782813383","13581.53","-0.86","EURd","SWAP","PROCESSED","2024-01-08 22:20:50","","VIX","Volatility Index","",""
"50130779662945","13582.39","2.25","EURd","SWAP","PROCESSED","2024-01-08 22:20:47","","Natural Gas","Natural Gas","",""
"50130779662787","13580.14","2.25","EURd","SWAP","PROCESSED","2024-01-08 22:20:47","","Natural Gas","Natural Gas","",""
"50130735612456","13577.89","-0.24","EURd","SWAP","PROCESSED","2024-01-08 22:20:05","","INTC","Intel Corp (Extended Hours)","",""
"50098468843518","13578.13","15.34","EURd","TRADE","PROCESSED","2024-01-08 13:47:13","00016258-0055-311e-0000-4d12000a555c_00016258-0055-311e-0000-00008053138d","VIX","Volatility Index","",""
"50098459406298","13562.79","15.3","EURd","TRADE","PROCESSED","2024-01-08 13:47:04","0015421d-0055-311e-0000-4d120008cd5d_0015421d-0055-311e-0000-000080ee449e","ETH/USD","Ethereum / USD","",""
"50040233028614","13547.49","-1.81","EURd","SWAP","PROCESSED","2024-01-07 22:21:35","","VIX","Volatility Index","",""
"50040233028477","13549.3","-0.9","EURd","SWAP","PROCESSED","2024-01-07 22:21:35","","VIX","Volatility Index","",""
"50040233028217","13550.2","-0.9","EURd","SWAP","PROCESSED","2024-01-07 22:21:35","","VIX","Volatility Index","",""
"50040233028165","13551.1","-0.9","EURd","SWAP","PROCESSED","2024-01-07 22:21:35","","VIX","Volatility Index","",""
"50040233028005","13552","-0.9","EURd","SWAP","PROCESSED","2024-01-07 22:21:35","","VIX","Volatility Index","",""
"50040233027906","13552.9","-0.9","EURd","SWAP","PROCESSED","2024-01-07 22:21:35","","VIX","Volatility Index","",""
"50040233027798","13553.8","-0.9","EURd","SWAP","PROCESSED","2024-01-07 22:21:35","","VIX","Volatility Index","",""
"50040214159132","13554.7","-0.29","EURd","SWAP","PROCESSED","2024-01-07 22:21:17","","TSLA","Tesla Inc (Extended Hours)","",""
"50040213110313","13554.99","-0.58","EURd","SWAP","PROCESSED","2024-01-07 22:21:16","","TSLA","Tesla Inc (Extended Hours)","",""
"50040213109389","13555.57","-0.58","EURd","SWAP","PROCESSED","2024-01-07 22:21:16","","TSLA","Tesla Inc (Extended Hours)","",""
"50040151236666","13556.15","1.47","EURd","SWAP","PROCESSED","2024-01-07 22:20:17","","Natural Gas","Natural Gas","",""
"50040151236556","13554.68","1.47","EURd","SWAP","PROCESSED","2024-01-07 22:20:17","","Natural Gas","Natural Gas","",""
"50040134453359","13553.21","-0.23","EURd","SWAP","PROCESSED","2024-01-07 22:20:01","","INTC","Intel Corp (Extended Hours)","",""
"49949669606680","13553.44","-0.23","EURd","SWAP","PROCESSED","2024-01-06 22:22:07","","INTC","Intel Corp (Extended Hours)","",""
"49949660178659","13553.67","-0.29","EURd","SWAP","PROCESSED","2024-01-06 22:21:58","","TSLA","Tesla Inc (Extended Hours)","",""
"49949660178540","13553.96","-0.58","EURd","SWAP","PROCESSED","2024-01-06 22:21:58","","TSLA","Tesla Inc (Extended Hours)","",""
"49949659129425","13554.54","-0.58","EURd","SWAP","PROCESSED","2024-01-06 22:21:57","","TSLA","Tesla Inc (Extended Hours)","",""
"49949585734896","13555.12","1.47","EURd","SWAP","PROCESSED","2024-01-06 22:20:47","","Natural Gas","Natural Gas","",""
"49949585734729","13553.65","1.47","EURd","SWAP","PROCESSED","2024-01-06 22:20:47","","Natural Gas","Natural Gas","",""
"49949567898688","13552.18","-1.81","EURd","SWAP","PROCESSED","2024-01-06 22:20:30","","VIX","Volatility Index","",""
"49949567898581","13553.99","-0.9","EURd","SWAP","PROCESSED","2024-01-06 22:20:30","","VIX","Volatility Index","",""
"49949567898344","13554.89","-0.9","EURd","SWAP","PROCESSED","2024-01-06 22:20:30","","VIX","Volatility Index","",""
"49949567898280","13555.79","-0.9","EURd","SWAP","PROCESSED","2024-01-06 22:20:30","","VIX","Volatility Index","",""
"49949567898149","13556.69","-0.9","EURd","SWAP","PROCESSED","2024-01-06 22:20:30","","VIX","Volatility Index","",""
"49949567898093","13557.59","-0.9","EURd","SWAP","PROCESSED","2024-01-06 22:20:30","","VIX","Volatility Index","",""
"49949567897961","13558.49","-0.9","EURd","SWAP","PROCESSED","2024-01-06 22:20:30","","VIX","Volatility Index","",""
"49863935940287","13559.39","19.27","EURd","TRADE","PROCESSED","2024-01-05 23:39:25","0015421d-0055-311e-0000-4d0f000ca7a7_0015421d-0055-311e-0000-000080ee1347","ETH/USD","Ethereum / USD","",""
"49859074740018","13540.12","-0.23","EURd","SWAP","PROCESSED","2024-01-05 22:22:09","","INTC","Intel Corp (Extended Hours)","",""
"49859047480225","13540.35","-1.81","EURd","SWAP","PROCESSED","2024-01-05 22:21:43","","VIX","Volatility Index","",""
"49859047480114","13542.16","-0.9","EURd","SWAP","PROCESSED","2024-01-05 22:21:43","","VIX","Volatility Index","",""
"49859047479873","13543.06","-0.9","EURd","SWAP","PROCESSED","2024-01-05 22:21:43","","VIX","Volatility Index","",""
"49859047479810","13543.96","-0.9","EURd","SWAP","PROCESSED","2024-01-05 22:21:43","","VIX","Volatility Index","",""
"49859046431108","13544.86","-0.9","EURd","SWAP","PROCESSED","2024-01-05 22:21:42","","VIX","Volatility Index","",""
"49859046431048","13545.76","-0.9","EURd","SWAP","PROCESSED","2024-01-05 22:21:42","","VIX","Volatility Index","",""
"49859046430934","13546.66","-0.9","EURd","SWAP","PROCESSED","2024-01-05 22:21:42","","VIX","Volatility Index","",""
"49858999238745","13547.56","-0.64","EURd","SWAP","PROCESSED","2024-01-05 22:20:57","","ETH/USD","Ethereum / USD","",""
"49858974084648","13548.2","1.78","EURd","SWAP","PROCESSED","2024-01-05 22:20:33","","Natural Gas","Natural Gas","",""
"49858974084534","13546.42","1.78","EURd","SWAP","PROCESSED","2024-01-05 22:20:33","","Natural Gas","Natural Gas","",""
"49858959400630","13544.64","-0.29","EURd","SWAP","PROCESSED","2024-01-05 22:20:19","","TSLA","Tesla Inc (Extended Hours)","",""
"49858959400368","13544.93","-0.58","EURd","SWAP","PROCESSED","2024-01-05 22:20:19","","TSLA","Tesla Inc (Extended Hours)","",""
"49858959399413","13545.51","-0.58","EURd","SWAP","PROCESSED","2024-01-05 22:20:19","","TSLA","Tesla Inc (Extended Hours)","",""
"49839021769175","13546.09","33.23","EURd","TRADE","PROCESSED","2024-01-05 17:03:25","0024e503-0055-311e-0000-4d0f000d4c63_0024e503-0055-311e-0000-0000802705c0","INTC","Intel Corp (Extended Hours)","",""
"49768478833043","13512.86","-0.23","EURd","SWAP","PROCESSED","2024-01-04 22:22:10","","INTC","Intel Corp (Extended Hours)","",""
"49768478833024","13513.09","-0.23","EURd","SWAP","PROCESSED","2024-01-04 22:22:10","","INTC","Intel Corp (Extended Hours)","",""
"49768466239591","13513.32","-0.29","EURd","SWAP","PROCESSED","2024-01-04 22:21:58","","TSLA","Tesla Inc (Extended Hours)","",""
"49768466239433","13513.61","-0.58","EURd","SWAP","PROCESSED","2024-01-04 22:21:58","","TSLA","Tesla Inc (Extended Hours)","",""
"49768466238793","13514.19","-0.58","EURd","SWAP","PROCESSED","2024-01-04 22:21:58","","TSLA","Tesla Inc (Extended Hours)","",""
"49768394945534","13514.77","-1.72","EURd","SWAP","PROCESSED","2024-01-04 22:20:50","","VIX","Volatility Index","",""
"49768394945416","13516.49","-0.86","EURd","SWAP","PROCESSED","2024-01-04 22:20:50","","VIX","Volatility Index","",""
"49768393896592","13517.35","-0.86","EURd","SWAP","PROCESSED","2024-01-04 22:20:49","","VIX","Volatility Index","",""
"49768393896549","13518.21","-0.86","EURd","SWAP","PROCESSED","2024-01-04 22:20:49","","VIX","Volatility Index","",""
"49768393896402","13519.07","-0.86","EURd","SWAP","PROCESSED","2024-01-04 22:20:49","","VIX","Volatility Index","",""
"49768393896331","13519.93","-0.86","EURd","SWAP","PROCESSED","2024-01-04 22:20:49","","VIX","Volatility Index","",""
"49768393896231","13520.79","-0.86","EURd","SWAP","PROCESSED","2024-01-04 22:20:49","","VIX","Volatility Index","",""
"49768390746085","13521.65","1.89","EURd","SWAP","PROCESSED","2024-01-04 22:20:46","","Natural Gas","Natural Gas","",""
"49768390745981","13519.76","1.89","EURd","SWAP","PROCESSED","2024-01-04 22:20:46","","Natural Gas","Natural Gas","",""
"49733916706336","13517.87","6.84","EURd","TRADE","PROCESSED","2024-01-04 13:12:49","0015421d-0055-311e-0000-4d0e00067096_0015421d-0055-311e-0000-000080ed098a","ETH/USD","Ethereum / USD","",""
"49733915657748","13511.03","10.59","EURd","TRADE","PROCESSED","2024-01-04 13:12:48","000940dd-0055-311e-0000-4d0e00077fbb_000940dd-0055-311e-0000-000081b90c4b","BTC/USD","Bitcoin / USD","",""
"49677895487485","13500.44","-0.23","EURd","SWAP","PROCESSED","2024-01-03 22:22:23","","INTC","Intel Corp (Extended Hours)","",""
"49677881862208","13500.67","-0.29","EURd","SWAP","PROCESSED","2024-01-03 22:22:10","","TSLA","Tesla Inc (Extended Hours)","",""
"49677881862018","13500.96","-0.58","EURd","SWAP","PROCESSED","2024-01-03 22:22:10","","TSLA","Tesla Inc (Extended Hours)","",""
"49677880812796","13501.54","-0.58","EURd","SWAP","PROCESSED","2024-01-03 22:22:09","","TSLA","Tesla Inc (Extended Hours)","",""
"49677859847598","13502.12","-0.63","EURd","SWAP","PROCESSED","2024-01-03 22:21:49","","ETH/USD","Ethereum / USD","",""
"49677818948854","13502.75","-0.49","EURd","SWAP","PROCESSED","2024-01-03 22:21:10","","BTC/USD","Bitcoin / USD","",""
"49677764414203","13503.24","-1.72","EURd","SWAP","PROCESSED","2024-01-03 22:20:18","","VIX","Volatility Index","",""
"49677764414088","13504.96","-0.86","EURd","SWAP","PROCESSED","2024-01-03 22:20:18","","VIX","Volatility Index","",""
"49677764413835","13505.82","-0.86","EURd","SWAP","PROCESSED","2024-01-03 22:20:18","","VIX","Volatility Index","",""
"49677764413782","13506.68","-0.86","EURd","SWAP","PROCESSED","2024-01-03 22:20:18","","VIX","Volatility Index","",""
"49677763365110","13507.54","-0.86","EURd","SWAP","PROCESSED","2024-01-03 22:20:17","","VIX","Volatility Index","",""
"49677763365059","13508.4","-0.86","EURd","SWAP","PROCESSED","2024-01-03 22:20:17","","VIX","Volatility Index","",""
"49677763364915","13509.26","-0.86","EURd","SWAP","PROCESSED","2024-01-03 22:20:17","","VIX","Volatility Index","",""
"49677759180002","13510.12","1.52","EURd","SWAP","PROCESSED","2024-01-03 22:20:13","","Natural Gas","Natural Gas","",""
"49677758131307","13508.6","1.52","EURd","SWAP","PROCESSED","2024-01-03 22:20:12","","Natural Gas","Natural Gas","",""
"49673629876414","13507.08","8.65","EURd","TRADE","PROCESSED","2024-01-03 21:14:35","00081081-0055-311e-0000-4d0d001d3d79_00081081-0055-311e-0000-000080280755","BABA","Alibaba Group Holding Limited (Extended Hours)","",""
"49673629876412","13498.43","6.41","EURd","TRADE","PROCESSED","2024-01-03 21:14:35","00081081-0055-311e-0000-4d0d001d3d78_00081081-0055-311e-0000-00008028069d","BABA","Alibaba Group Holding Limited (Extended Hours)","",""
"49587296423517","13492.02","-0.24","EURd","SWAP","PROCESSED","2024-01-02 22:22:21","","INTC","Intel Corp (Extended Hours)","",""
"49587286996560","13492.26","-0.3","EURd","SWAP","PROCESSED","2024-01-02 22:22:12","","TSLA","Tesla Inc (Extended Hours)","",""
"49587286996432","13492.56","-0.6","EURd","SWAP","PROCESSED","2024-01-02 22:22:12","","TSLA","Tesla Inc (Extended Hours)","",""
"49587285947383","13493.16","-0.6","EURd","SWAP","PROCESSED","2024-01-02 22:22:11","","TSLA","Tesla Inc (Extended Hours)","",""
"49587236664230","13493.76","-0.37","EURd","SWAP","PROCESSED","2024-01-02 22:21:24","","BABA","Alibaba Group Holding Limited (Extended Hours)","",""
"49587155912440","13494.13","-2.26","EURd","SWAP","PROCESSED","2024-01-02 22:20:07","","VIX","Volatility Index","",""
"49587155912308","13496.39","-1.13","EURd","SWAP","PROCESSED","2024-01-02 22:20:07","","VIX","Volatility Index","",""
"49587155912020","13497.52","-1.13","EURd","SWAP","PROCESSED","2024-01-02 22:20:07","","VIX","Volatility Index","",""
"49587155911963","13498.65","-1.13","EURd","SWAP","PROCESSED","2024-01-02 22:20:07","","VIX","Volatility Index","",""
"49587155911863","13499.78","-1.13","EURd","SWAP","PROCESSED","2024-01-02 22:20:07","","VIX","Volatility Index","",""
"49587155911778","13500.91","-1.13","EURd","SWAP","PROCESSED","2024-01-02 22:20:07","","VIX","Volatility Index","",""
"49587155911677","13502.04","-1.13","EURd","SWAP","PROCESSED","2024-01-02 22:20:07","","VIX","Volatility Index","",""
"49587151729398","13503.17","1.71","EURd","SWAP","PROCESSED","2024-01-02 22:20:03","","Natural Gas","Natural Gas","",""
"49587151729274","13501.46","1.71","EURd","SWAP","PROCESSED","2024-01-02 22:20:03","","Natural Gas","Natural Gas","",""
"49500389405234","13499.75","11.42","EURd","TRADE","PROCESSED","2024-01-01 23:21:00","00018387-0055-311e-0000-4d0b0000e867_00018387-0055-311e-0000-000080efd480","Natural Gas","Natural Gas","",""
"49500376822288","13488.33","15.42","EURd","TRADE","PROCESSED","2024-01-01 23:20:48","0015421d-0055-311e-0000-4d0b000070df_0015421d-0055-311e-0000-000080ecc3e0","ETH/USD","Ethereum / USD","",""
"49500373676551","13472.91","47.94","EURd","TRADE","PROCESSED","2024-01-01 23:20:45","000940dd-0055-311e-0000-4d0b0000b929_000940dd-0055-311e-0000-000081b81fee","BTC/USD","Bitcoin / USD","",""
"49496688979654","13424.97","-0.65","EURd","SWAP","PROCESSED","2024-01-01 22:22:11","","ETH/USD","Ethereum / USD","",""
"49496645983738","13425.62","-1.21","EURd","SWAP","PROCESSED","2024-01-01 22:21:30","","BTC/USD","Bitcoin / USD","",""
"49496597747466","13426.83","-0.6","EURd","SWAP","PROCESSED","2024-01-01 22:20:44","","TSLA","Tesla Inc (Extended Hours)","",""
"49496596697574","13427.43","-0.6","EURd","SWAP","PROCESSED","2024-01-01 22:20:43","","TSLA","Tesla Inc (Extended Hours)","",""
"49496577829436","13428.03","1.29","EURd","SWAP","PROCESSED","2024-01-01 22:20:25","","Natural Gas","Natural Gas","",""
"49496577829043","13426.74","1.29","EURd","SWAP","PROCESSED","2024-01-01 22:20:25","","Natural Gas","Natural Gas","",""
"49496577828928","13425.45","1.29","EURd","SWAP","PROCESSED","2024-01-01 22:20:25","","Natural Gas","Natural Gas","",""
"49496563144612","13424.16","-2.81","EURd","SWAP","PROCESSED","2024-01-01 22:20:11","","VIX","Volatility Index","",""
"49496563144481","13426.97","-1.41","EURd","SWAP","PROCESSED","2024-01-01 22:20:11","","VIX","Volatility Index","",""
"49496563144203","13428.38","-1.41","EURd","SWAP","PROCESSED","2024-01-01 22:20:11","","VIX","Volatility Index","",""
"49496563144143","13429.79","-1.41","EURd","SWAP","PROCESSED","2024-01-01 22:20:11","","VIX","Volatility Index","",""
"49496563143994","13431.2","-1.41","EURd","SWAP","PROCESSED","2024-01-01 22:20:11","","VIX","Volatility Index","",""
"49496563143927","13432.61","-1.41","EURd","SWAP","PROCESSED","2024-01-01 22:20:11","","VIX","Volatility Index","",""
"49496563143827","13434.02","-1.41","EURd","SWAP","PROCESSED","2024-01-01 22:20:11","","VIX","Volatility Index","",""
"49406080483089","13435.43","-0.64","EURd","SWAP","PROCESSED","2023-12-31 22:22:00","","ETH/USD","Ethereum / USD","",""
"49406056365682","13436.07","-1.19","EURd","SWAP","PROCESSED","2023-12-31 22:21:37","","BTC/USD","Bitcoin / USD","",""
"49406020708173","13437.26","-0.6","EURd","SWAP","PROCESSED","2023-12-31 22:21:03","","TSLA","Tesla Inc (Extended Hours)","",""
"49406019658179","13437.86","-0.6","EURd","SWAP","PROCESSED","2023-12-31 22:21:02","","TSLA","Tesla Inc (Extended Hours)","",""
"49405981904334","13438.46","-2.6","EURd","SWAP","PROCESSED","2023-12-31 22:20:26","","VIX","Volatility Index","",""
"49405981904210","13441.06","-1.3","EURd","SWAP","PROCESSED","2023-12-31 22:20:26","","VIX","Volatility Index","",""
"49405981903972","13442.36","-1.3","EURd","SWAP","PROCESSED","2023-12-31 22:20:26","","VIX","Volatility Index","",""
"49405981903906","13443.66","-1.3","EURd","SWAP","PROCESSED","2023-12-31 22:20:26","","VIX","Volatility Index","",""
"49405981903782","13444.96","-1.3","EURd","SWAP","PROCESSED","2023-12-31 22:20:26","","VIX","Volatility Index","",""
"49405981903726","13446.26","-1.3","EURd","SWAP","PROCESSED","2023-12-31 22:20:26","","VIX","Volatility Index","",""
"49405981903609","13447.56","-1.3","EURd","SWAP","PROCESSED","2023-12-31 22:20:26","","VIX","Volatility Index","",""
"49405958835702","13448.86","1.25","EURd","SWAP","PROCESSED","2023-12-31 22:20:04","","Natural Gas","Natural Gas","",""
"49405957786748","13447.61","1.25","EURd","SWAP","PROCESSED","2023-12-31 22:20:03","","Natural Gas","Natural Gas","",""
"49405957786604","13446.36","1.25","EURd","SWAP","PROCESSED","2023-12-31 22:20:03","","Natural Gas","Natural Gas","",""
"49315501337814","13445.11","-2.6","EURd","SWAP","PROCESSED","2023-12-30 22:22:17","","VIX","Volatility Index","",""
"49315501337775","13447.71","-1.3","EURd","SWAP","PROCESSED","2023-12-30 22:22:17","","VIX","Volatility Index","",""
"49315501337711","13449.01","-1.3","EURd","SWAP","PROCESSED","2023-12-30 22:22:17","","VIX","Volatility Index","",""
"49315501337695","13450.31","-1.3","EURd","SWAP","PROCESSED","2023-12-30 22:22:17","","VIX","Volatility Index","",""
"49315501337651","13451.61","-1.3","EURd","SWAP","PROCESSED","2023-12-30 22:22:17","","VIX","Volatility Index","",""
"49315501337640","13452.91","-1.3","EURd","SWAP","PROCESSED","2023-12-30 22:22:17","","VIX","Volatility Index","",""
"49315501337608","13454.21","-1.3","EURd","SWAP","PROCESSED","2023-12-30 22:22:17","","VIX","Volatility Index","",""
"49315495042498","13455.51","-0.64","EURd","SWAP","PROCESSED","2023-12-30 22:22:11","","ETH/USD","Ethereum / USD","",""
"49315484563436","13456.15","-1.19","EURd","SWAP","PROCESSED","2023-12-30 22:22:01","","BTC/USD","Bitcoin / USD","",""
"49315453093916","13457.34","-0.6","EURd","SWAP","PROCESSED","2023-12-30 22:21:31","","TSLA","Tesla Inc (Extended Hours)","",""
"49315452043977","13457.94","-0.6","EURd","SWAP","PROCESSED","2023-12-30 22:21:30","","TSLA","Tesla Inc (Extended Hours)","",""
"49315421640463","13458.54","1.25","EURd","SWAP","PROCESSED","2023-12-30 22:21:01","","Natural Gas","Natural Gas","",""
"49315421640112","13457.29","1.25","EURd","SWAP","PROCESSED","2023-12-30 22:21:01","","Natural Gas","Natural Gas","",""
"49315421639983","13456.04","1.25","EURd","SWAP","PROCESSED","2023-12-30 22:21:01","","Natural Gas","Natural Gas","",""
"49224905415135","13454.79","1.29","EURd","SWAP","PROCESSED","2023-12-29 22:22:18","","Natural Gas","Natural Gas","",""
"49224905415014","13453.5","1.29","EURd","SWAP","PROCESSED","2023-12-29 22:22:18","","Natural Gas","Natural Gas","",""
"49224905414966","13452.21","1.29","EURd","SWAP","PROCESSED","2023-12-29 22:22:18","","Natural Gas","Natural Gas","",""
"49224903316901","13450.92","-0.6","EURd","SWAP","PROCESSED","2023-12-29 22:22:16","","TSLA","Tesla Inc (Extended Hours)","",""
"49224903316395","13451.52","-0.6","EURd","SWAP","PROCESSED","2023-12-29 22:22:16","","TSLA","Tesla Inc (Extended Hours)","",""
"49224882340662","13452.12","-2.6","EURd","SWAP","PROCESSED","2023-12-29 22:21:56","","VIX","Volatility Index","",""
"49224882340554","13454.72","-1.3","EURd","SWAP","PROCESSED","2023-12-29 22:21:56","","VIX","Volatility Index","",""
"49224882340350","13456.02","-1.3","EURd","SWAP","PROCESSED","2023-12-29 22:21:56","","VIX","Volatility Index","",""
"49224882340281","13457.32","-1.3","EURd","SWAP","PROCESSED","2023-12-29 22:21:56","","VIX","Volatility Index","",""
"49224882340159","13458.62","-1.3","EURd","SWAP","PROCESSED","2023-12-29 22:21:56","","VIX","Volatility Index","",""
"49224882340102","13459.92","-1.3","EURd","SWAP","PROCESSED","2023-12-29 22:21:56","","VIX","Volatility Index","",""
"49224882339979","13461.22","-1.3","EURd","SWAP","PROCESSED","2023-12-29 22:21:56","","VIX","Volatility Index","",""
"49224871856640","13462.52","-0.64","EURd","SWAP","PROCESSED","2023-12-29 22:21:46","","ETH/USD","Ethereum / USD","",""
"49224843552702","13463.16","-1.17","EURd","SWAP","PROCESSED","2023-12-29 22:21:19","","BTC/USD","Bitcoin / USD","",""
"49134306356928","13464.33","-0.61","EURd","SWAP","PROCESSED","2023-12-28 22:22:16","","TSLA","Tesla Inc (Extended Hours)","",""
"49134283280377","13464.94","-2.77","EURd","SWAP","PROCESSED","2023-12-28 22:21:54","","VIX","Volatility Index","",""
"49134283280270","13467.71","-1.39","EURd","SWAP","PROCESSED","2023-12-28 22:21:54","","VIX","Volatility Index","",""
"49134282231480","13469.1","-1.39","EURd","SWAP","PROCESSED","2023-12-28 22:21:53","","VIX","Volatility Index","",""
"49134282231412","13470.49","-1.39","EURd","SWAP","PROCESSED","2023-12-28 22:21:53","","VIX","Volatility Index","",""
"49134282231303","13471.88","-1.39","EURd","SWAP","PROCESSED","2023-12-28 22:21:53","","VIX","Volatility Index","",""
"49134282231249","13473.27","-1.39","EURd","SWAP","PROCESSED","2023-12-28 22:21:53","","VIX","Volatility Index","",""
"49134282231103","13474.66","-1.39","EURd","SWAP","PROCESSED","2023-12-28 22:21:53","","VIX","Volatility Index","",""
"49134250781830","13476.05","1.31","EURd","SWAP","PROCESSED","2023-12-28 22:21:23","","Natural Gas","Natural Gas","",""
"49134250781435","13474.74","1.31","EURd","SWAP","PROCESSED","2023-12-28 22:21:23","","Natural Gas","Natural Gas","",""
"49134250781289","13473.43","1.31","EURd","SWAP","PROCESSED","2023-12-28 22:21:23","","Natural Gas","Natural Gas","",""
"49134224562253","13472.12","-1.19","EURd","SWAP","PROCESSED","2023-12-28 22:20:58","","BTC/USD","Bitcoin / USD","",""
"49043690515102","13473.31","-2.22","EURd","SWAP","PROCESSED","2023-12-27 22:21:58","","VIX","Volatility Index","",""
"49043690515018","13475.53","-1.12","EURd","SWAP","PROCESSED","2023-12-27 22:21:58","","VIX","Volatility Index","",""
"49043690514826","13476.65","-1.12","EURd","SWAP","PROCESSED","2023-12-27 22:21:58","","VIX","Volatility Index","",""
"49043690514774","13477.77","-1.12","EURd","SWAP","PROCESSED","2023-12-27 22:21:58","","VIX","Volatility Index","",""
"49043690514708","13478.89","-1.12","EURd","SWAP","PROCESSED","2023-12-27 22:21:58","","VIX","Volatility Index","",""
"49043690514650","13480.01","-1.12","EURd","SWAP","PROCESSED","2023-12-27 22:21:58","","VIX","Volatility Index","",""
"49043690514545","13481.13","-1.12","EURd","SWAP","PROCESSED","2023-12-27 22:21:58","","VIX","Volatility Index","",""
"49043620259141","13482.25","1.19","EURd","SWAP","PROCESSED","2023-12-27 22:20:51","","Natural Gas","Natural Gas","",""
"49043620258673","13481.06","1.19","EURd","SWAP","PROCESSED","2023-12-27 22:20:51","","Natural Gas","Natural Gas","",""
"49043620258436","13479.87","1.19","EURd","SWAP","PROCESSED","2023-12-27 22:20:51","","Natural Gas","Natural Gas","",""
"49019465253019","13478.68","22.69","EURd","TRADE","PROCESSED","2023-12-27 15:56:55","00018387-0055-311e-0000-4d06000ce5d2_00018387-0055-311e-0000-000080f1a4f7","Natural Gas","Natural Gas","",""
"49019461058703","13455.99","-36.78","EURd","TRADE","PROCESSED","2023-12-27 15:56:51","000940dd-0055-311e-0000-4d0600080b68_000940dd-0055-311e-0000-000081b74dd3","BTC/USD","Bitcoin / USD","",""
"49019461058702","13492.77","47.1","EURd","TRADE","PROCESSED","2023-12-27 15:56:51","000940dd-0055-311e-0000-4d0600080b67_000940dd-0055-311e-0000-000081b7e084","BTC/USD","Bitcoin / USD","",""
"49019457912958","13445.67","24.06","EURd","TRADE","PROCESSED","2023-12-27 15:56:48","0015421d-0055-311e-0000-4d060006a74e_0015421d-0055-311e-0000-000080ec725c","ETH/USD","Ethereum / USD","",""
"49019457912957","13421.61","63.06","EURd","TRADE","PROCESSED","2023-12-27 15:56:48","0015421d-0055-311e-0000-4d060006a74d_0015421d-0055-311e-0000-000080ec98de","ETH/USD","Ethereum / USD","",""
"48953105075261","13358.55","-2.24","EURd","SWAP","PROCESSED","2023-12-26 22:22:09","","VIX","Volatility Index","",""
"48953105075203","13360.79","-1.12","EURd","SWAP","PROCESSED","2023-12-26 22:22:09","","VIX","Volatility Index","",""
"48953105075100","13361.91","-1.12","EURd","SWAP","PROCESSED","2023-12-26 22:22:09","","VIX","Volatility Index","",""
"48953105075061","13363.03","-1.12","EURd","SWAP","PROCESSED","2023-12-26 22:22:09","","VIX","Volatility Index","",""
"48953105075001","13364.15","-1.12","EURd","SWAP","PROCESSED","2023-12-26 22:22:09","","VIX","Volatility Index","",""
"48953105074972","13365.27","-1.12","EURd","SWAP","PROCESSED","2023-12-26 22:22:09","","VIX","Volatility Index","",""
"48953105074925","13366.39","-1.12","EURd","SWAP","PROCESSED","2023-12-26 22:22:09","","VIX","Volatility Index","",""
"48953077811203","13367.51","-0.62","EURd","SWAP","PROCESSED","2023-12-26 22:21:43","","ETH/USD","Ethereum / USD","",""
"48953077810255","13368.13","-0.62","EURd","SWAP","PROCESSED","2023-12-26 22:21:43","","ETH/USD","Ethereum / USD","",""
"48953059990730","13368.75","-1.2","EURd","SWAP","PROCESSED","2023-12-26 22:21:26","","BTC/USD","Bitcoin / USD","",""
"48953056841023","13369.95","-1.2","EURd","SWAP","PROCESSED","2023-12-26 22:21:23","","BTC/USD","Bitcoin / USD","",""
"48953026437076","13371.15","1.2","EURd","SWAP","PROCESSED","2023-12-26 22:20:54","","Natural Gas","Natural Gas","",""
"48953025385978","13369.95","1.2","EURd","SWAP","PROCESSED","2023-12-26 22:20:53","","Natural Gas","Natural Gas","",""
"48953024336918","13368.75","1.2","EURd","SWAP","PROCESSED","2023-12-26 22:20:52","","Natural Gas","Natural Gas","",""
"48953024336722","13367.55","1.2","EURd","SWAP","PROCESSED","2023-12-26 22:20:52","","Natural Gas","Natural Gas","",""
"48862500777345","13366.35","-2.19","EURd","SWAP","PROCESSED","2023-12-25 22:22:02","","VIX","Volatility Index","",""
"48862500777290","13368.54","-1.1","EURd","SWAP","PROCESSED","2023-12-25 22:22:02","","VIX","Volatility Index","",""
"48862500777159","13369.64","-1.1","EURd","SWAP","PROCESSED","2023-12-25 22:22:02","","VIX","Volatility Index","",""
"48862500777115","13370.74","-1.1","EURd","SWAP","PROCESSED","2023-12-25 22:22:02","","VIX","Volatility Index","",""
"48862500777062","13371.84","-1.1","EURd","SWAP","PROCESSED","2023-12-25 22:22:02","","VIX","Volatility Index","",""
"48862500777023","13372.94","-1.1","EURd","SWAP","PROCESSED","2023-12-25 22:22:02","","VIX","Volatility Index","",""
"48862500776949","13374.04","-1.1","EURd","SWAP","PROCESSED","2023-12-25 22:22:02","","VIX","Volatility Index","",""
"48862483995495","13375.14","-0.64","EURd","SWAP","PROCESSED","2023-12-25 22:21:46","","ETH/USD","Ethereum / USD","",""
"48862467225167","13375.78","-1.22","EURd","SWAP","PROCESSED","2023-12-25 22:21:30","","BTC/USD","Bitcoin / USD","",""
"48862435754445","13377","0.83","EURd","SWAP","PROCESSED","2023-12-25 22:21:00","","Natural Gas","Natural Gas","",""
"48862434721784","13376.17","0.83","EURd","SWAP","PROCESSED","2023-12-25 22:20:59","","Natural Gas","Natural Gas","",""
"48862434721590","13375.34","0.83","EURd","SWAP","PROCESSED","2023-12-25 22:20:59","","Natural Gas","Natural Gas","",""
"48771913251279","13374.51","-2.15","EURd","SWAP","PROCESSED","2023-12-24 22:22:11","","VIX","Volatility Index","",""
"48771913251232","13376.66","-1.08","EURd","SWAP","PROCESSED","2023-12-24 22:22:11","","VIX","Volatility Index","",""
"48771912202553","13377.74","-1.08","EURd","SWAP","PROCESSED","2023-12-24 22:22:10","","VIX","Volatility Index","",""
"48771912202526","13378.82","-1.08","EURd","SWAP","PROCESSED","2023-12-24 22:22:10","","VIX","Volatility Index","",""
"48771912202466","13379.9","-1.08","EURd","SWAP","PROCESSED","2023-12-24 22:22:10","","VIX","Volatility Index","",""
"48771912202446","13380.98","-1.08","EURd","SWAP","PROCESSED","2023-12-24 22:22:10","","VIX","Volatility Index","",""
"48771912202393","13382.06","-1.08","EURd","SWAP","PROCESSED","2023-12-24 22:22:10","","VIX","Volatility Index","",""
"48771898557848","13383.14","-0.64","EURd","SWAP","PROCESSED","2023-12-24 22:21:56","","ETH/USD","Ethereum / USD","",""
"48771890175599","13383.78","0.83","EURd","SWAP","PROCESSED","2023-12-24 22:21:49","","Natural Gas","Natural Gas","",""
"48771890175106","13382.95","0.83","EURd","SWAP","PROCESSED","2023-12-24 22:21:49","","Natural Gas","Natural Gas","",""
"48771890174966","13382.12","0.83","EURd","SWAP","PROCESSED","2023-12-24 22:21:49","","Natural Gas","Natural Gas","",""
"48771844034769","13381.29","-1.21","EURd","SWAP","PROCESSED","2023-12-24 22:21:05","","BTC/USD","Bitcoin / USD","",""
"48681308941089","13382.5","-0.64","EURd","SWAP","PROCESSED","2023-12-23 22:22:04","","ETH/USD","Ethereum / USD","",""
"48681299508798","13383.14","0.83","EURd","SWAP","PROCESSED","2023-12-23 22:21:55","","Natural Gas","Natural Gas","",""
"48681299508315","13382.31","0.83","EURd","SWAP","PROCESSED","2023-12-23 22:21:55","","Natural Gas","Natural Gas","",""
"48681299508126","13381.48","0.83","EURd","SWAP","PROCESSED","2023-12-23 22:21:55","","Natural Gas","Natural Gas","",""
"48681277474670","13380.65","-2.15","EURd","SWAP","PROCESSED","2023-12-23 22:21:34","","VIX","Volatility Index","",""
"48681277474533","13382.8","-1.08","EURd","SWAP","PROCESSED","2023-12-23 22:21:34","","VIX","Volatility Index","",""
"48681277474292","13383.88","-1.08","EURd","SWAP","PROCESSED","2023-12-23 22:21:34","","VIX","Volatility Index","",""
"48681277474228","13384.96","-1.08","EURd","SWAP","PROCESSED","2023-12-23 22:21:34","","VIX","Volatility Index","",""
"48681277474113","13386.04","-1.08","EURd","SWAP","PROCESSED","2023-12-23 22:21:34","","VIX","Volatility Index","",""
"48681277474063","13387.12","-1.08","EURd","SWAP","PROCESSED","2023-12-23 22:21:34","","VIX","Volatility Index","",""
"48681277473958","13388.2","-1.08","EURd","SWAP","PROCESSED","2023-12-23 22:21:34","","VIX","Volatility Index","",""
"48681240773028","13389.28","-1.23","EURd","SWAP","PROCESSED","2023-12-23 22:20:59","","BTC/USD","Bitcoin / USD","",""
"48590704625135","13390.51","1","EURd","SWAP","PROCESSED","2023-12-22 22:21:57","","Natural Gas","Natural Gas","",""
"48590704624728","13389.51","1","EURd","SWAP","PROCESSED","2023-12-22 22:21:57","","Natural Gas","Natural Gas","",""
"48590704624569","13388.51","1","EURd","SWAP","PROCESSED","2023-12-22 22:21:57","","Natural Gas","Natural Gas","",""
"48590698340348","13387.51","-2.15","EURd","SWAP","PROCESSED","2023-12-22 22:21:51","","VIX","Volatility Index","",""
"48590698340207","13389.66","-1.08","EURd","SWAP","PROCESSED","2023-12-22 22:21:51","","VIX","Volatility Index","",""
"48590697291313","13390.74","-1.08","EURd","SWAP","PROCESSED","2023-12-22 22:21:50","","VIX","Volatility Index","",""
"48590697291260","13391.82","-1.08","EURd","SWAP","PROCESSED","2023-12-22 22:21:50","","VIX","Volatility Index","",""
"48590697291125","13392.9","-1.08","EURd","SWAP","PROCESSED","2023-12-22 22:21:50","","VIX","Volatility Index","",""
"48590697291086","13393.98","-1.08","EURd","SWAP","PROCESSED","2023-12-22 22:21:50","","VIX","Volatility Index","",""
"48590697290972","13395.06","-1.08","EURd","SWAP","PROCESSED","2023-12-22 22:21:50","","VIX","Volatility Index","",""
"48590609215634","13396.14","-1.23","EURd","SWAP","PROCESSED","2023-12-22 22:20:26","","BTC/USD","Bitcoin / USD","",""
"48587425740420","13397.37","10.72","EURd","TRADE","PROCESSED","2023-12-22 21:29:50","00081081-0055-311e-0000-4d0100171a3c_00081081-0055-311e-0000-0000802803bf","BABA","Alibaba Group Holding Limited (Extended Hours)","",""
"48587423643266","13386.65","17.71","EURd","TRADE","PROCESSED","2023-12-22 21:29:48","00018387-0055-311e-0000-4d0100198d36_00018387-0055-311e-0000-000080f182d7","Natural Gas","Natural Gas","",""
"48559155081521","13368.94","9.02","EURd","TRADE","PROCESSED","2023-12-22 14:00:29","00513301-0055-311e-0000-4d010007a8f8_00513301-0055-311e-0000-0000808f6f78","TSLA","Tesla Inc (Extended Hours)","",""
"48559155081520","13359.92","1.22","EURd","TRADE","PROCESSED","2023-12-22 14:00:29","00513301-0055-311e-0000-4d010007a8f7_00513301-0055-311e-0000-0000808f3c36","TSLA","Tesla Inc (Extended Hours)","",""
"48559151935774","13358.7","25.56","EURd","TRADE","PROCESSED","2023-12-22 14:00:26","0015421d-0055-311e-0000-4d010006302d_0015421d-0055-311e-0000-000080ec5c4a","ETH/USD","Ethereum / USD","",""
"48529617733712","13333.14","38.59","EURd","TRADE","PROCESSED","2023-12-22 06:11:00","00018387-0055-311e-0000-4d0100030513_00018387-0055-311e-0000-000080f12f41","Natural Gas","Natural Gas","",""
"48500122343217","13294.55","0.82","EURd","SWAP","PROCESSED","2023-12-21 22:22:11","","Natural Gas","Natural Gas","",""
"48500121293871","13293.73","0.82","EURd","SWAP","PROCESSED","2023-12-21 22:22:10","","Natural Gas","Natural Gas","",""
"48500121293616","13292.91","0.82","EURd","SWAP","PROCESSED","2023-12-21 22:22:10","","Natural Gas","Natural Gas","",""
"48500121293523","13292.09","0.82","EURd","SWAP","PROCESSED","2023-12-21 22:22:10","","Natural Gas","Natural Gas","",""
"48500105564874","13291.27","26.88","EURd","TRADE","PROCESSED","2023-12-21 22:21:55","00081081-0055-311e-0000-4d00001ac30a_00081081-0055-311e-0000-0000802801a9","BABA","Alibaba Group Holding Limited (Extended Hours)","",""
"48500047892663","13264.39","-0.36","EURd","SWAP","PROCESSED","2023-12-21 22:21:00","","BABA","Alibaba Group Holding Limited (Extended Hours)","",""
"48500014338544","13264.75","-2.24","EURd","SWAP","PROCESSED","2023-12-21 22:20:28","","VIX","Volatility Index","",""
"48500014338441","13266.99","-1.13","EURd","SWAP","PROCESSED","2023-12-21 22:20:28","","VIX","Volatility Index","",""
"48500014338221","13268.12","-1.13","EURd","SWAP","PROCESSED","2023-12-21 22:20:28","","VIX","Volatility Index","",""
"48500014338158","13269.25","-1.13","EURd","SWAP","PROCESSED","2023-12-21 22:20:28","","VIX","Volatility Index","",""
"48500014338065","13270.38","-1.13","EURd","SWAP","PROCESSED","2023-12-21 22:20:28","","VIX","Volatility Index","",""
"48500014338004","13271.51","-1.13","EURd","SWAP","PROCESSED","2023-12-21 22:20:28","","VIX","Volatility Index","",""
"48500014337882","13272.64","-1.13","EURd","SWAP","PROCESSED","2023-12-21 22:20:28","","VIX","Volatility Index","",""
"48500012239417","13273.77","-0.31","EURd","SWAP","PROCESSED","2023-12-21 22:20:26","","TSLA","Tesla Inc (Extended Hours)","",""
"48409519085663","13274.08","-2.27","EURd","SWAP","PROCESSED","2023-12-20 22:22:05","","VIX","Volatility Index","",""
"48409519085399","13276.35","-1.13","EURd","SWAP","PROCESSED","2023-12-20 22:22:05","","VIX","Volatility Index","",""
"48409518036676","13277.48","-1.13","EURd","SWAP","PROCESSED","2023-12-20 22:22:04","","VIX","Volatility Index","",""
"48409518036639","13278.61","-1.13","EURd","SWAP","PROCESSED","2023-12-20 22:22:04","","VIX","Volatility Index","",""
"48409518036565","13279.74","-1.13","EURd","SWAP","PROCESSED","2023-12-20 22:22:04","","VIX","Volatility Index","",""
"48409518036525","13280.87","-1.13","EURd","SWAP","PROCESSED","2023-12-20 22:22:04","","VIX","Volatility Index","",""
"48409518036433","13282","-1.13","EURd","SWAP","PROCESSED","2023-12-20 22:22:04","","VIX","Volatility Index","",""
"48409514887539","13283.13","-0.3","EURd","SWAP","PROCESSED","2023-12-20 22:22:01","","TSLA","Tesla Inc (Extended Hours)","",""
"48409490770380","13283.43","1.3","EURd","SWAP","PROCESSED","2023-12-20 22:21:38","","Natural Gas","Natural Gas","",""
"48409489720103","13282.13","1.3","EURd","SWAP","PROCESSED","2023-12-20 22:21:37","","Natural Gas","Natural Gas","",""
"48409489719487","13280.83","1.3","EURd","SWAP","PROCESSED","2023-12-20 22:21:37","","Natural Gas","Natural Gas","",""
"48409487636682","13279.53","1.3","EURd","SWAP","PROCESSED","2023-12-20 22:21:35","","Natural Gas","Natural Gas","",""
"48409434147625","13278.23","-0.36","EURd","SWAP","PROCESSED","2023-12-20 22:20:44","","BABA","Alibaba Group Holding Limited (Extended Hours)","",""
"48377243919839","13278.59","13.38","EURd","TRADE","PROCESSED","2023-12-20 13:49:05","0015421d-0055-311e-0000-4cff00063e94_0015421d-0055-311e-0000-000080ec328e","ETH/USD","Ethereum / USD","",""
"48377243919838","13265.21","21.38","EURd","TRADE","PROCESSED","2023-12-20 13:49:05","0015421d-0055-311e-0000-4cff00063e93_0015421d-0055-311e-0000-000080ec3379","ETH/USD","Ethereum / USD","",""
"48377241822673","13243.83","37.31","EURd","TRADE","PROCESSED","2023-12-20 13:49:03","000940dd-0055-311e-0000-4cff0006ef82_000940dd-0055-311e-0000-000081b6e0aa","BTC/USD","Bitcoin / USD","",""
"48318924211575","13206.52","-2.25","EURd","SWAP","PROCESSED","2023-12-19 22:22:07","","VIX","Volatility Index","",""
"48318923162886","13208.77","-1.13","EURd","SWAP","PROCESSED","2023-12-19 22:22:06","","VIX","Volatility Index","",""
"48318923162761","13209.9","-1.13","EURd","SWAP","PROCESSED","2023-12-19 22:22:06","","VIX","Volatility Index","",""
"48318923162726","13211.03","-1.13","EURd","SWAP","PROCESSED","2023-12-19 22:22:06","","VIX","Volatility Index","",""
"48318923162659","13212.16","-1.13","EURd","SWAP","PROCESSED","2023-12-19 22:22:06","","VIX","Volatility Index","",""
"48318923162612","13213.29","-1.13","EURd","SWAP","PROCESSED","2023-12-19 22:22:06","","VIX","Volatility Index","",""
"48318923162545","13214.42","-1.13","EURd","SWAP","PROCESSED","2023-12-19 22:22:06","","VIX","Volatility Index","",""
"48318906397922","13215.55","-0.61","EURd","SWAP","PROCESSED","2023-12-19 22:21:50","","ETH/USD","Ethereum / USD","",""
"48318905349292","13216.16","-0.61","EURd","SWAP","PROCESSED","2023-12-19 22:21:49","","ETH/USD","Ethereum / USD","",""
"48318877028024","13216.77","0.73","EURd","SWAP","PROCESSED","2023-12-19 22:21:22","","Natural Gas","Natural Gas","",""
"48318875977492","13216.04","0.73","EURd","SWAP","PROCESSED","2023-12-19 22:21:21","","Natural Gas","Natural Gas","",""
"48318875976959","13215.31","0.73","EURd","SWAP","PROCESSED","2023-12-19 22:21:21","","Natural Gas","Natural Gas","",""
"48318875976741","13214.58","0.73","EURd","SWAP","PROCESSED","2023-12-19 22:21:21","","Natural Gas","Natural Gas","",""
"48318848723083","13213.85","-1.19","EURd","SWAP","PROCESSED","2023-12-19 22:20:55","","BTC/USD","Bitcoin / USD","",""
"48315931588347","13215.04","4.68","EURd","TRADE","PROCESSED","2023-12-19 21:34:33","00396101-0055-311e-0000-4cfe001543c2_00396101-0055-311e-0000-0000802a0c05","NVDA","NVIDIA Corp (Extended Hours)","",""
"48294161044237","13210.36","25.87","EURd","TRADE","PROCESSED","2023-12-19 15:48:31","00081081-0055-311e-0000-4cfe00087fd0_00081081-0055-311e-0000-0000802703b7","BABA","Alibaba Group Holding Limited (Extended Hours)","",""
"48294161044236","13184.49","16.03","EURd","TRADE","PROCESSED","2023-12-19 15:48:31","00081081-0055-311e-0000-4cfe00087fcf_00081081-0055-311e-0000-000080270365","BABA","Alibaba Group Holding Limited (Extended Hours)","",""
"48294161044235","13168.46","9.11","EURd","TRADE","PROCESSED","2023-12-19 15:48:31","00081081-0055-311e-0000-4cfe00087fce_00081081-0055-311e-0000-0000802702cd","BABA","Alibaba Group Holding Limited (Extended Hours)","",""
"48282074116498","13159.35","32.53","EURd","TRADE","PROCESSED","2023-12-19 12:36:24","0015421d-0055-311e-0000-4cfe00059683_0015421d-0055-311e-0000-000080ec2752","ETH/USD","Ethereum / USD","",""
"48228261190504","13126.82","-0.63","EURd","SWAP","PROCESSED","2023-12-18 22:21:04","","ETH/USD","Ethereum / USD","",""
"48228249654750","13127.45","0.81","EURd","SWAP","PROCESSED","2023-12-18 22:20:53","","Natural Gas","Natural Gas","",""
"48228248605625","13126.64","0.81","EURd","SWAP","PROCESSED","2023-12-18 22:20:52","","Natural Gas","Natural Gas","",""
"48228248605469","13125.83","0.81","EURd","SWAP","PROCESSED","2023-12-18 22:20:52","","Natural Gas","Natural Gas","",""
"48228238121374","13125.02","-0.36","EURd","SWAP","PROCESSED","2023-12-18 22:20:42","","BABA","Alibaba Group Holding Limited (Extended Hours)","",""
"48228238121314","13125.38","-0.36","EURd","SWAP","PROCESSED","2023-12-18 22:20:42","","BABA","Alibaba Group Holding Limited (Extended Hours)","",""
"48228238121261","13125.74","-0.36","EURd","SWAP","PROCESSED","2023-12-18 22:20:42","","BABA","Alibaba Group Holding Limited (Extended Hours)","",""
"48228230785857","13126.1","-3.35","EURd","SWAP","PROCESSED","2023-12-18 22:20:35","","VIX","Volatility Index","",""
"48228230785671","13129.45","-1.68","EURd","SWAP","PROCESSED","2023-12-18 22:20:35","","VIX","Volatility Index","",""
"48228230785447","13131.13","-1.68","EURd","SWAP","PROCESSED","2023-12-18 22:20:35","","VIX","Volatility Index","",""
"48228229736805","13132.81","-1.68","EURd","SWAP","PROCESSED","2023-12-18 22:20:34","","VIX","Volatility Index","",""
"48228229736690","13134.49","-1.68","EURd","SWAP","PROCESSED","2023-12-18 22:20:34","","VIX","Volatility Index","",""
"48228229736613","13136.17","-1.68","EURd","SWAP","PROCESSED","2023-12-18 22:20:34","","VIX","Volatility Index","",""
"48228229736463","13137.85","-1.68","EURd","SWAP","PROCESSED","2023-12-18 22:20:34","","VIX","Volatility Index","",""
"48207368310494","13139.53","-10.96","EURd","TRADE","PROCESSED","2023-12-18 16:48:59","00513301-0055-311e-0000-4cfd000b6d71_00513301-0055-311e-0000-00008088a0ba","TSLA","Tesla Inc (Extended Hours)","",""
"48207368310493","13150.49","-24.51","EURd","TRADE","PROCESSED","2023-12-18 16:48:59","00513301-0055-311e-0000-4cfd000b6d70_00513301-0055-311e-0000-000080888ae0","TSLA","Tesla Inc (Extended Hours)","",""
"48207368310491","13175","80.32","EURd","TRADE","PROCESSED","2023-12-18 16:48:59","00513301-0055-311e-0000-4cfd000b6d6f_00513301-0055-311e-0000-0000808e5371","TSLA","Tesla Inc (Extended Hours)","",""
"48207368310490","13094.68","11.98","EURd","TRADE","PROCESSED","2023-12-18 16:48:59","00513301-0055-311e-0000-4cfd000b6d6e_00513301-0055-311e-0000-00008088b01b","TSLA","Tesla Inc (Extended Hours)","",""
"48137679960987","13082.7","-0.36","EURd","SWAP","PROCESSED","2023-12-17 22:21:19","","BABA","Alibaba Group Holding Limited (Extended Hours)","",""
"48137679960928","13083.06","-0.36","EURd","SWAP","PROCESSED","2023-12-17 22:21:19","","BABA","Alibaba Group Holding Limited (Extended Hours)","",""
"48137679960819","13083.42","-0.36","EURd","SWAP","PROCESSED","2023-12-17 22:21:19","","BABA","Alibaba Group Holding Limited (Extended Hours)","",""
"48137674708998","13083.78","0.5","EURd","SWAP","PROCESSED","2023-12-17 22:21:14","","Natural Gas","Natural Gas","",""
"48137673659874","13083.28","0.5","EURd","SWAP","PROCESSED","2023-12-17 22:21:13","","Natural Gas","Natural Gas","",""
"48137673659688","13082.78","0.5","EURd","SWAP","PROCESSED","2023-12-17 22:21:13","","Natural Gas","Natural Gas","",""
"48137640104951","13082.28","-3.07","EURd","SWAP","PROCESSED","2023-12-17 22:20:41","","VIX","Volatility Index","",""
"48137640104721","13085.35","-1.54","EURd","SWAP","PROCESSED","2023-12-17 22:20:41","","VIX","Volatility Index","",""
"48137639055851","13086.89","-1.54","EURd","SWAP","PROCESSED","2023-12-17 22:20:40","","VIX","Volatility Index","",""
"48137639055782","13088.43","-1.54","EURd","SWAP","PROCESSED","2023-12-17 22:20:40","","VIX","Volatility Index","",""
"48137639055679","13089.97","-1.54","EURd","SWAP","PROCESSED","2023-12-17 22:20:40","","VIX","Volatility Index","",""
"48137639055579","13091.51","-1.54","EURd","SWAP","PROCESSED","2023-12-17 22:20:40","","VIX","Volatility Index","",""
"48137639055464","13093.05","-1.54","EURd","SWAP","PROCESSED","2023-12-17 22:20:40","","VIX","Volatility Index","",""
"48137632770414","13094.59","-0.31","EURd","SWAP","PROCESSED","2023-12-17 22:20:34","","TSLA","Tesla Inc (Extended Hours)","",""
"48137627520027","13094.9","-0.13","EURd","SWAP","PROCESSED","2023-12-17 22:20:29","","TSLA","Tesla Inc (Extended Hours)","",""
"48137627519911","13095.03","-0.18","EURd","SWAP","PROCESSED","2023-12-17 22:20:29","","TSLA","Tesla Inc (Extended Hours)","",""
"48137627519852","13095.21","-0.18","EURd","SWAP","PROCESSED","2023-12-17 22:20:29","","TSLA","Tesla Inc (Extended Hours)","",""
"48047106057604","13095.39","-0.36","EURd","SWAP","PROCESSED","2023-12-16 22:21:41","","BABA","Alibaba Group Holding Limited (Extended Hours)","",""
"48047106057548","13095.75","-0.36","EURd","SWAP","PROCESSED","2023-12-16 22:21:41","","BABA","Alibaba Group Holding Limited (Extended Hours)","",""
"48047106057466","13096.11","-0.36","EURd","SWAP","PROCESSED","2023-12-16 22:21:41","","BABA","Alibaba Group Holding Limited (Extended Hours)","",""
"48047080886506","13096.47","-0.31","EURd","SWAP","PROCESSED","2023-12-16 22:21:17","","TSLA","Tesla Inc (Extended Hours)","",""
"48047075652307","13096.78","-0.13","EURd","SWAP","PROCESSED","2023-12-16 22:21:12","","TSLA","Tesla Inc (Extended Hours)","",""
"48047075652170","13096.91","-0.18","EURd","SWAP","PROCESSED","2023-12-16 22:21:12","","TSLA","Tesla Inc (Extended Hours)","",""
"48047075652092","13097.09","-0.18","EURd","SWAP","PROCESSED","2023-12-16 22:21:12","","TSLA","Tesla Inc (Extended Hours)","",""
"48047057818060","13097.27","0.5","EURd","SWAP","PROCESSED","2023-12-16 22:20:55","","Natural Gas","Natural Gas","",""
"48047057817602","13096.77","0.5","EURd","SWAP","PROCESSED","2023-12-16 22:20:55","","Natural Gas","Natural Gas","",""
"48047057817391","13096.27","0.5","EURd","SWAP","PROCESSED","2023-12-16 22:20:55","","Natural Gas","Natural Gas","",""
"48047021113547","13095.77","-3.07","EURd","SWAP","PROCESSED","2023-12-16 22:20:20","","VIX","Volatility Index","",""
"48047021129699","13098.84","-1.54","EURd","SWAP","PROCESSED","2023-12-16 22:20:20","","VIX","Volatility Index","",""
"48047021129426","13100.38","-1.54","EURd","SWAP","PROCESSED","2023-12-16 22:20:20","","VIX","Volatility Index","",""
"48047020080803","13101.92","-1.54","EURd","SWAP","PROCESSED","2023-12-16 22:20:19","","VIX","Volatility Index","",""
"48047020080679","13103.46","-1.54","EURd","SWAP","PROCESSED","2023-12-16 22:20:19","","VIX","Volatility Index","",""
"48047020080617","13105","-1.54","EURd","SWAP","PROCESSED","2023-12-16 22:20:19","","VIX","Volatility Index","",""
"48047020080502","13106.54","-1.54","EURd","SWAP","PROCESSED","2023-12-16 22:20:19","","VIX","Volatility Index","",""
"47956514326260","13108.08","0.5","EURd","SWAP","PROCESSED","2023-12-15 22:21:46","","Natural Gas","Natural Gas","",""
"47956514325720","13107.58","0.5","EURd","SWAP","PROCESSED","2023-12-15 22:21:46","","Natural Gas","Natural Gas","",""
"47956514325490","13107.08","0.5","EURd","SWAP","PROCESSED","2023-12-15 22:21:46","","Natural Gas","Natural Gas","",""
"47956481820918","13106.58","-0.36","EURd","SWAP","PROCESSED","2023-12-15 22:21:15","","BABA","Alibaba Group Holding Limited (Extended Hours)","",""
"47956481820854","13106.94","-0.36","EURd","SWAP","PROCESSED","2023-12-15 22:21:15","","BABA","Alibaba Group Holding Limited (Extended Hours)","",""
"47956481820806","13107.3","-0.36","EURd","SWAP","PROCESSED","2023-12-15 22:21:15","","BABA","Alibaba Group Holding Limited (Extended Hours)","",""
"47956455616931","13107.66","-3.07","EURd","SWAP","PROCESSED","2023-12-15 22:20:50","","VIX","Volatility Index","",""
"47956455616673","13110.73","-1.54","EURd","SWAP","PROCESSED","2023-12-15 22:20:50","","VIX","Volatility Index","",""
"47956455616468","13112.27","-1.54","EURd","SWAP","PROCESSED","2023-12-15 22:20:50","","VIX","Volatility Index","",""
"47956454567848","13113.81","-1.54","EURd","SWAP","PROCESSED","2023-12-15 22:20:49","","VIX","Volatility Index","",""
"47956454567698","13115.35","-1.54","EURd","SWAP","PROCESSED","2023-12-15 22:20:49","","VIX","Volatility Index","",""
"47956454567621","13116.89","-1.54","EURd","SWAP","PROCESSED","2023-12-15 22:20:49","","VIX","Volatility Index","",""
"47956454567484","13118.43","-1.54","EURd","SWAP","PROCESSED","2023-12-15 22:20:49","","VIX","Volatility Index","",""
"47956430447450","13119.97","-0.31","EURd","SWAP","PROCESSED","2023-12-15 22:20:26","","TSLA","Tesla Inc (Extended Hours)","",""
"47956425196759","13120.28","-0.13","EURd","SWAP","PROCESSED","2023-12-15 22:20:21","","TSLA","Tesla Inc (Extended Hours)","",""
"47956425196620","13120.41","-0.18","EURd","SWAP","PROCESSED","2023-12-15 22:20:21","","TSLA","Tesla Inc (Extended Hours)","",""
"47956424147979","13120.59","-0.18","EURd","SWAP","PROCESSED","2023-12-15 22:20:20","","TSLA","Tesla Inc (Extended Hours)","",""
"47865921563835","13120.77","0.57","EURd","SWAP","PROCESSED","2023-12-14 22:21:50","","Natural Gas","Natural Gas","",""
"47865920514715","13120.2","0.57","EURd","SWAP","PROCESSED","2023-12-14 22:21:49","","Natural Gas","Natural Gas","",""
"47865920514328","13119.63","0.57","EURd","SWAP","PROCESSED","2023-12-14 22:21:49","","Natural Gas","Natural Gas","",""
"47865871227481","13119.06","-0.35","EURd","SWAP","PROCESSED","2023-12-14 22:21:02","","BABA","Alibaba Group Holding Limited (Extended Hours)","",""
"47865871227412","13119.41","-0.35","EURd","SWAP","PROCESSED","2023-12-14 22:21:02","","BABA","Alibaba Group Holding Limited (Extended Hours)","",""
"47865871227355","13119.76","-0.35","EURd","SWAP","PROCESSED","2023-12-14 22:21:02","","BABA","Alibaba Group Holding Limited (Extended Hours)","",""
"47865848159692","13120.11","-3.33","EURd","SWAP","PROCESSED","2023-12-14 22:20:40","","VIX","Volatility Index","",""
"47865847110929","13123.44","-1.66","EURd","SWAP","PROCESSED","2023-12-14 22:20:39","","VIX","Volatility Index","",""
"47865847110667","13125.1","-1.66","EURd","SWAP","PROCESSED","2023-12-14 22:20:39","","VIX","Volatility Index","",""
"47865847110572","13126.76","-1.66","EURd","SWAP","PROCESSED","2023-12-14 22:20:39","","VIX","Volatility Index","",""
"47865847110444","13128.42","-1.66","EURd","SWAP","PROCESSED","2023-12-14 22:20:39","","VIX","Volatility Index","",""
"47865847110373","13130.08","-1.66","EURd","SWAP","PROCESSED","2023-12-14 22:20:39","","VIX","Volatility Index","",""
"47865847110245","13131.74","-1.66","EURd","SWAP","PROCESSED","2023-12-14 22:20:39","","VIX","Volatility Index","",""
"47865830326580","13133.4","-0.3","EURd","SWAP","PROCESSED","2023-12-14 22:20:23","","TSLA","Tesla Inc (Extended Hours)","",""
"47865825091852","13133.7","-0.13","EURd","SWAP","PROCESSED","2023-12-14 22:20:18","","TSLA","Tesla Inc (Extended Hours)","",""
"47865825091745","13133.83","-0.18","EURd","SWAP","PROCESSED","2023-12-14 22:20:18","","TSLA","Tesla Inc (Extended Hours)","",""
"47865824043100","13134.01","-0.18","EURd","SWAP","PROCESSED","2023-12-14 22:20:17","","TSLA","Tesla Inc (Extended Hours)","",""
"47775363396122","13134.19","-0.35","EURd","SWAP","PROCESSED","2023-12-13 22:22:27","","BABA","Alibaba Group Holding Limited (Extended Hours)","",""
"47775363396104","13134.54","-0.35","EURd","SWAP","PROCESSED","2023-12-13 22:22:27","","BABA","Alibaba Group Holding Limited (Extended Hours)","",""
"47775363396082","13134.89","-0.35","EURd","SWAP","PROCESSED","2023-12-13 22:22:27","","BABA","Alibaba Group Holding Limited (Extended Hours)","",""
"47775345573500","13135.24","-3.36","EURd","SWAP","PROCESSED","2023-12-13 22:22:10","","VIX","Volatility Index","",""
"47775344524133","13138.6","-1.68","EURd","SWAP","PROCESSED","2023-12-13 22:22:09","","VIX","Volatility Index","",""
"47775344523850","13140.28","-1.68","EURd","SWAP","PROCESSED","2023-12-13 22:22:09","","VIX","Volatility Index","",""
"47775344523741","13141.96","-1.68","EURd","SWAP","PROCESSED","2023-12-13 22:22:09","","VIX","Volatility Index","",""
"47775344523616","13143.64","-1.68","EURd","SWAP","PROCESSED","2023-12-13 22:22:09","","VIX","Volatility Index","",""
"47775344523516","13145.32","-1.68","EURd","SWAP","PROCESSED","2023-12-13 22:22:09","","VIX","Volatility Index","",""
"47775344523443","13147","-1.68","EURd","SWAP","PROCESSED","2023-12-13 22:22:09","","VIX","Volatility Index","",""
"47775276358235","13148.68","0.61","EURd","SWAP","PROCESSED","2023-12-13 22:21:04","","Natural Gas","Natural Gas","",""
"47775275309057","13148.07","0.61","EURd","SWAP","PROCESSED","2023-12-13 22:21:03","","Natural Gas","Natural Gas","",""
"47775275308594","13147.46","0.61","EURd","SWAP","PROCESSED","2023-12-13 22:21:03","","Natural Gas","Natural Gas","",""
"47775220791614","13146.85","-0.29","EURd","SWAP","PROCESSED","2023-12-13 22:20:11","","TSLA","Tesla Inc (Extended Hours)","",""
"47775213443251","13147.14","-0.12","EURd","SWAP","PROCESSED","2023-12-13 22:20:04","","TSLA","Tesla Inc (Extended Hours)","",""
"47775213443114","13147.26","-0.17","EURd","SWAP","PROCESSED","2023-12-13 22:20:04","","TSLA","Tesla Inc (Extended Hours)","",""
"47775213443055","13147.43","-0.17","EURd","SWAP","PROCESSED","2023-12-13 22:20:04","","TSLA","Tesla Inc (Extended Hours)","",""
"47684753846562","13147.6","-0.12","EURd","SWAP","PROCESSED","2023-12-12 22:22:15","","TSLA","Tesla Inc (Extended Hours)","",""
"47684753846512","13147.72","-0.18","EURd","SWAP","PROCESSED","2023-12-12 22:22:15","","TSLA","Tesla Inc (Extended Hours)","",""
"47684753846475","13147.9","-0.18","EURd","SWAP","PROCESSED","2023-12-12 22:22:15","","TSLA","Tesla Inc (Extended Hours)","",""
"47684748599838","13148.08","-0.35","EURd","SWAP","PROCESSED","2023-12-12 22:22:10","","BABA","Alibaba Group Holding Limited (Extended Hours)","",""
"47684748599800","13148.43","-0.35","EURd","SWAP","PROCESSED","2023-12-12 22:22:10","","BABA","Alibaba Group Holding Limited (Extended Hours)","",""
"47684748599750","13148.78","-0.35","EURd","SWAP","PROCESSED","2023-12-12 22:22:10","","BABA","Alibaba Group Holding Limited (Extended Hours)","",""
"47684720287374","13149.13","-2.83","EURd","SWAP","PROCESSED","2023-12-12 22:21:43","","VIX","Volatility Index","",""
"47684720287199","13151.96","-1.42","EURd","SWAP","PROCESSED","2023-12-12 22:21:43","","VIX","Volatility Index","",""
"47684720286905","13153.38","-1.42","EURd","SWAP","PROCESSED","2023-12-12 22:21:43","","VIX","Volatility Index","",""
"47684720286839","13154.8","-1.42","EURd","SWAP","PROCESSED","2023-12-12 22:21:43","","VIX","Volatility Index","",""
"47684720286715","13156.22","-1.42","EURd","SWAP","PROCESSED","2023-12-12 22:21:43","","VIX","Volatility Index","",""
"47684720286641","13157.64","-1.42","EURd","SWAP","PROCESSED","2023-12-12 22:21:43","","VIX","Volatility Index","",""
"47684720286489","13159.06","-1.42","EURd","SWAP","PROCESSED","2023-12-12 22:21:43","","VIX","Volatility Index","",""
"47684697218118","13160.48","0.8","EURd","SWAP","PROCESSED","2023-12-12 22:21:21","","Natural Gas","Natural Gas","",""
"47684697217451","13159.68","0.8","EURd","SWAP","PROCESSED","2023-12-12 22:21:21","","Natural Gas","Natural Gas","",""
"47684697217070","13158.88","0.8","EURd","SWAP","PROCESSED","2023-12-12 22:21:21","","Natural Gas","Natural Gas","",""
"47594152686730","13158.08","-0.12","EURd","SWAP","PROCESSED","2023-12-11 22:22:11","","TSLA","Tesla Inc (Extended Hours)","",""
"47594151638088","13158.2","-0.18","EURd","SWAP","PROCESSED","2023-12-11 22:22:10","","TSLA","Tesla Inc (Extended Hours)","",""
"47594151638054","13158.38","-0.18","EURd","SWAP","PROCESSED","2023-12-11 22:22:10","","TSLA","Tesla Inc (Extended Hours)","",""
"47594125425452","13158.56","-2.85","EURd","SWAP","PROCESSED","2023-12-11 22:21:45","","VIX","Volatility Index","",""
"47594125425188","13161.41","-1.43","EURd","SWAP","PROCESSED","2023-12-11 22:21:45","","VIX","Volatility Index","",""
"47594125424949","13162.84","-1.43","EURd","SWAP","PROCESSED","2023-12-11 22:21:45","","VIX","Volatility Index","",""
"47594125424878","13164.27","-1.43","EURd","SWAP","PROCESSED","2023-12-11 22:21:45","","VIX","Volatility Index","",""
"47594125424684","13165.7","-1.43","EURd","SWAP","PROCESSED","2023-12-11 22:21:45","","VIX","Volatility Index","",""
"47594125424624","13167.13","-1.43","EURd","SWAP","PROCESSED","2023-12-11 22:21:45","","VIX","Volatility Index","",""
"47594125424520","13168.56","-1.43","EURd","SWAP","PROCESSED","2023-12-11 22:21:45","","VIX","Volatility Index","",""
"47594099205805","13169.99","0.69","EURd","SWAP","PROCESSED","2023-12-11 22:21:20","","Natural Gas","Natural Gas","",""
"47594099205168","13169.3","0.69","EURd","SWAP","PROCESSED","2023-12-11 22:21:20","","Natural Gas","Natural Gas","",""
"47594098156226","13168.61","0.69","EURd","SWAP","PROCESSED","2023-12-11 22:21:19","","Natural Gas","Natural Gas","",""
"47594038383894","13167.92","-0.35","EURd","SWAP","PROCESSED","2023-12-11 22:20:22","","BABA","Alibaba Group Holding Limited (Extended Hours)","",""
"47594038383833","13168.27","-0.35","EURd","SWAP","PROCESSED","2023-12-11 22:20:22","","BABA","Alibaba Group Holding Limited (Extended Hours)","",""
"47594038383760","13168.62","-0.35","EURd","SWAP","PROCESSED","2023-12-11 22:20:22","","BABA","Alibaba Group Holding Limited (Extended Hours)","",""
"47503555709592","13168.97","-0.12","EURd","SWAP","PROCESSED","2023-12-10 22:22:11","","TSLA","Tesla Inc (Extended Hours)","",""
"47503555709519","13169.09","-0.19","EURd","SWAP","PROCESSED","2023-12-10 22:22:11","","TSLA","Tesla Inc (Extended Hours)","",""
"47503555709484","13169.28","-0.19","EURd","SWAP","PROCESSED","2023-12-10 22:22:11","","TSLA","Tesla Inc (Extended Hours)","",""
"47503545229236","13169.47","-0.35","EURd","SWAP","PROCESSED","2023-12-10 22:22:01","","BABA","Alibaba Group Holding Limited (Extended Hours)","",""
"47503545229157","13169.82","-0.35","EURd","SWAP","PROCESSED","2023-12-10 22:22:01","","BABA","Alibaba Group Holding Limited (Extended Hours)","",""
"47503545229100","13170.17","-0.35","EURd","SWAP","PROCESSED","2023-12-10 22:22:01","","BABA","Alibaba Group Holding Limited (Extended Hours)","",""
"47503495946019","13170.52","0.5","EURd","SWAP","PROCESSED","2023-12-10 22:21:14","","Natural Gas","Natural Gas","",""
"47503494896340","13170.02","0.5","EURd","SWAP","PROCESSED","2023-12-10 22:21:13","","Natural Gas","Natural Gas","",""
"47503494895721","13169.52","0.5","EURd","SWAP","PROCESSED","2023-12-10 22:21:13","","Natural Gas","Natural Gas","",""
"47503438279698","13169.02","-2.85","EURd","SWAP","PROCESSED","2023-12-10 22:20:19","","VIX","Volatility Index","",""
"47503437229074","13171.87","-1.43","EURd","SWAP","PROCESSED","2023-12-10 22:20:18","","VIX","Volatility Index","",""
"47503437228786","13173.3","-1.43","EURd","SWAP","PROCESSED","2023-12-10 22:20:18","","VIX","Volatility Index","",""
"47503436179466","13174.73","-1.43","EURd","SWAP","PROCESSED","2023-12-10 22:20:17","","VIX","Volatility Index","",""
"47503436179274","13176.16","-1.43","EURd","SWAP","PROCESSED","2023-12-10 22:20:17","","VIX","Volatility Index","",""
"47503436179177","13177.59","-1.43","EURd","SWAP","PROCESSED","2023-12-10 22:20:17","","VIX","Volatility Index","",""
"47503436179018","13179.02","-1.43","EURd","SWAP","PROCESSED","2023-12-10 22:20:17","","VIX","Volatility Index","",""
"47412957693140","13180.45","-0.12","EURd","SWAP","PROCESSED","2023-12-09 22:22:10","","TSLA","Tesla Inc (Extended Hours)","",""
"47412957693086","13180.57","-0.19","EURd","SWAP","PROCESSED","2023-12-09 22:22:10","","TSLA","Tesla Inc (Extended Hours)","",""
"47412957693056","13180.76","-0.19","EURd","SWAP","PROCESSED","2023-12-09 22:22:10","","TSLA","Tesla Inc (Extended Hours)","",""
"47412933580235","13180.95","-0.35","EURd","SWAP","PROCESSED","2023-12-09 22:21:47","","BABA","Alibaba Group Holding Limited (Extended Hours)","",""
"47412933580183","13181.3","-0.35","EURd","SWAP","PROCESSED","2023-12-09 22:21:47","","BABA","Alibaba Group Holding Limited (Extended Hours)","",""
"47412933580105","13181.65","-0.35","EURd","SWAP","PROCESSED","2023-12-09 22:21:47","","BABA","Alibaba Group Holding Limited (Extended Hours)","",""
"47412891643487","13182","0.5","EURd","SWAP","PROCESSED","2023-12-09 22:21:07","","Natural Gas","Natural Gas","",""
"47412890593488","13181.5","0.5","EURd","SWAP","PROCESSED","2023-12-09 22:21:06","","Natural Gas","Natural Gas","",""
"47412889544305","13181","0.5","EURd","SWAP","PROCESSED","2023-12-09 22:21:05","","Natural Gas","Natural Gas","",""
"47412858090842","13180.5","-2.85","EURd","SWAP","PROCESSED","2023-12-09 22:20:35","","VIX","Volatility Index","",""
"47412857041043","13183.35","-1.43","EURd","SWAP","PROCESSED","2023-12-09 22:20:34","","VIX","Volatility Index","",""
"47412857040643","13184.78","-1.43","EURd","SWAP","PROCESSED","2023-12-09 22:20:34","","VIX","Volatility Index","",""
"47412857040582","13186.21","-1.43","EURd","SWAP","PROCESSED","2023-12-09 22:20:34","","VIX","Volatility Index","",""
"47412855991775","13187.64","-1.43","EURd","SWAP","PROCESSED","2023-12-09 22:20:33","","VIX","Volatility Index","",""
"47412855991738","13189.07","-1.43","EURd","SWAP","PROCESSED","2023-12-09 22:20:33","","VIX","Volatility Index","",""
"47412855991608","13190.5","-1.43","EURd","SWAP","PROCESSED","2023-12-09 22:20:33","","VIX","Volatility Index","",""
"47322307257753","13191.93","-0.35","EURd","SWAP","PROCESSED","2023-12-08 22:21:19","","BABA","Alibaba Group Holding Limited (Extended Hours)","",""
"47322307257688","13192.28","-0.35","EURd","SWAP","PROCESSED","2023-12-08 22:21:19","","BABA","Alibaba Group Holding Limited (Extended Hours)","",""
"47322307257662","13192.63","-0.35","EURd","SWAP","PROCESSED","2023-12-08 22:21:19","","BABA","Alibaba Group Holding Limited (Extended Hours)","",""
"47322287338075","13192.98","-0.12","EURd","SWAP","PROCESSED","2023-12-08 22:21:00","","TSLA","Tesla Inc (Extended Hours)","",""
"47322287337990","13193.1","-0.19","EURd","SWAP","PROCESSED","2023-12-08 22:21:00","","TSLA","Tesla Inc (Extended Hours)","",""
"47322286289349","13193.29","-0.19","EURd","SWAP","PROCESSED","2023-12-08 22:20:59","","TSLA","Tesla Inc (Extended Hours)","",""
"47322259019652","13193.48","-2.85","EURd","SWAP","PROCESSED","2023-12-08 22:20:33","","VIX","Volatility Index","",""
"47322259019115","13196.33","-1.43","EURd","SWAP","PROCESSED","2023-12-08 22:20:33","","VIX","Volatility Index","",""
"47322259018793","13197.76","-1.43","EURd","SWAP","PROCESSED","2023-12-08 22:20:33","","VIX","Volatility Index","",""
"47322259018732","13199.19","-1.43","EURd","SWAP","PROCESSED","2023-12-08 22:20:33","","VIX","Volatility Index","",""
"47322257969870","13200.62","-1.43","EURd","SWAP","PROCESSED","2023-12-08 22:20:32","","VIX","Volatility Index","",""
"47322257969831","13202.05","-1.43","EURd","SWAP","PROCESSED","2023-12-08 22:20:32","","VIX","Volatility Index","",""
"47322257969598","13203.48","-1.43","EURd","SWAP","PROCESSED","2023-12-08 22:20:32","","VIX","Volatility Index","",""
"47322246435375","13204.91","0.69","EURd","SWAP","PROCESSED","2023-12-08 22:20:21","","Natural Gas","Natural Gas","",""
"47322246434219","13204.22","0.69","EURd","SWAP","PROCESSED","2023-12-08 22:20:21","","Natural Gas","Natural Gas","",""
"47322245385019","13203.53","0.69","EURd","SWAP","PROCESSED","2023-12-08 22:20:20","","Natural Gas","Natural Gas","",""
"47310880919098","13202.84","11.43","EURd","TRADE","PROCESSED","2023-12-08 19:19:42","00513301-0055-311e-0000-4cf3000edb08_00513301-0055-311e-0000-0000808e153f","TSLA","Tesla Inc (Extended Hours)","",""
"47286783592898","13191.41","0.32","EURd","TRADE","PROCESSED","2023-12-08 12:56:41","00018509-0055-311e-0000-4cf3000811bd_00018509-0055-311e-0000-0000814469bf","Oil - Crude","Crude Oil","",""
"47286199534334","13191.09","2.97","EURd","TRADE","PROCESSED","2023-12-08 12:47:24","00081081-0055-311e-0000-4cf300018b67_00081081-0055-311e-0000-000080270705","BABA","Alibaba Group Holding Limited (Extended Hours)","",""
"47241346707873","13188.12","40.06","EURd","TRADE","PROCESSED","2023-12-08 00:54:29","0015421d-0055-311e-0000-4cf300006f37_0015421d-0055-311e-0000-000080eaa2aa","ETH/USD","Ethereum / USD","",""
"47231755384511","13148.06","0.51","EURd","SWAP","PROCESSED","2023-12-07 22:22:02","","Natural Gas","Natural Gas","",""
"47231754335269","13147.55","0.51","EURd","SWAP","PROCESSED","2023-12-07 22:22:01","","Natural Gas","Natural Gas","",""
"47231754334893","13147.04","0.51","EURd","SWAP","PROCESSED","2023-12-07 22:22:01","","Natural Gas","Natural Gas","",""
"47231719734045","13146.53","-0.68","EURd","SWAP","PROCESSED","2023-12-07 22:21:28","","ETH/USD","Ethereum / USD","",""
"47231694564332","13147.21","-0.12","EURd","SWAP","PROCESSED","2023-12-07 22:21:04","","TSLA","Tesla Inc (Extended Hours)","",""
"47231694564167","13147.33","-0.19","EURd","SWAP","PROCESSED","2023-12-07 22:21:04","","TSLA","Tesla Inc (Extended Hours)","",""
"47231694564096","13147.52","-0.19","EURd","SWAP","PROCESSED","2023-12-07 22:21:04","","TSLA","Tesla Inc (Extended Hours)","",""
"47231689313299","13147.71","-0.35","EURd","SWAP","PROCESSED","2023-12-07 22:20:59","","BABA","Alibaba Group Holding Limited (Extended Hours)","",""
"47231689313237","13148.06","-0.35","EURd","SWAP","PROCESSED","2023-12-07 22:20:59","","BABA","Alibaba Group Holding Limited (Extended Hours)","",""
"47231688264583","13148.41","-0.35","EURd","SWAP","PROCESSED","2023-12-07 22:20:58","","BABA","Alibaba Group Holding Limited (Extended Hours)","",""
"47231648425215","13148.76","-0.14","EURd","SWAP","PROCESSED","2023-12-07 22:20:20","","Oil - Crude","Crude Oil","",""
"47231632691621","13148.9","-1.43","EURd","SWAP","PROCESSED","2023-12-07 22:20:05","","VIX","Volatility Index","",""
"47231632690889","13150.33","-1.43","EURd","SWAP","PROCESSED","2023-12-07 22:20:05","","VIX","Volatility Index","",""
"47231632690678","13151.76","-1.43","EURd","SWAP","PROCESSED","2023-12-07 22:20:05","","VIX","Volatility Index","",""
"47231631641805","13153.19","-1.43","EURd","SWAP","PROCESSED","2023-12-07 22:20:04","","VIX","Volatility Index","",""
"47231631641497","13154.62","-1.43","EURd","SWAP","PROCESSED","2023-12-07 22:20:04","","VIX","Volatility Index","",""
"47231631641376","13156.05","-1.43","EURd","SWAP","PROCESSED","2023-12-07 22:20:04","","VIX","Volatility Index","",""
"47141150015590","13157.48","-0.14","EURd","SWAP","PROCESSED","2023-12-06 22:21:54","","Oil - Crude","Crude Oil","",""
"47141133248451","13157.62","-1.43","EURd","SWAP","PROCESSED","2023-12-06 22:21:38","","VIX","Volatility Index","",""
"47141133248149","13159.05","-1.43","EURd","SWAP","PROCESSED","2023-12-06 22:21:38","","VIX","Volatility Index","",""
"47141133248095","13160.48","-1.43","EURd","SWAP","PROCESSED","2023-12-06 22:21:38","","VIX","Volatility Index","",""
"47141133247876","13161.91","-1.43","EURd","SWAP","PROCESSED","2023-12-06 22:21:38","","VIX","Volatility Index","",""
"47141133247810","13163.34","-1.43","EURd","SWAP","PROCESSED","2023-12-06 22:21:38","","VIX","Volatility Index","",""
"47141133247687","13164.77","-1.43","EURd","SWAP","PROCESSED","2023-12-06 22:21:38","","VIX","Volatility Index","",""
"47141090257326","13166.2","0.4","EURd","SWAP","PROCESSED","2023-12-06 22:20:57","","Natural Gas","Natural Gas","",""
"47141089208148","13165.8","0.4","EURd","SWAP","PROCESSED","2023-12-06 22:20:56","","Natural Gas","Natural Gas","",""
"47141086058066","13165.4","-0.65","EURd","SWAP","PROCESSED","2023-12-06 22:20:53","","ETH/USD","Ethereum / USD","",""
"47141044120115","13166.05","-0.12","EURd","SWAP","PROCESSED","2023-12-06 22:20:13","","TSLA","Tesla Inc (Extended Hours)","",""
"47141044119999","13166.17","-0.18","EURd","SWAP","PROCESSED","2023-12-06 22:20:13","","TSLA","Tesla Inc (Extended Hours)","",""
"47141044119932","13166.35","-0.18","EURd","SWAP","PROCESSED","2023-12-06 22:20:13","","TSLA","Tesla Inc (Extended Hours)","",""
"47141032586551","13166.53","-0.35","EURd","SWAP","PROCESSED","2023-12-06 22:20:02","","BABA","Alibaba Group Holding Limited (Extended Hours)","",""
"47141032586497","13166.88","-0.35","EURd","SWAP","PROCESSED","2023-12-06 22:20:02","","BABA","Alibaba Group Holding Limited (Extended Hours)","",""
"47141032586427","13167.23","-0.35","EURd","SWAP","PROCESSED","2023-12-06 22:20:02","","BABA","Alibaba Group Holding Limited (Extended Hours)","",""
"47109621444851","13167.58","8.84","EURd","TRADE","PROCESSED","2023-12-06 14:00:46","00513301-0055-311e-0000-4cf100081bc5_00513301-0055-311e-0000-0000808dd2f0","TSLA","Tesla Inc (Extended Hours)","",""
"47050565637578","13158.74","-0.3","EURd","SWAP","PROCESSED","2023-12-05 22:22:06","","TSLA","Tesla Inc (Extended Hours)","",""
"47050561440087","13159.04","-0.12","EURd","SWAP","PROCESSED","2023-12-05 22:22:02","","TSLA","Tesla Inc (Extended Hours)","",""
"47050561440043","13159.16","-0.18","EURd","SWAP","PROCESSED","2023-12-05 22:22:02","","TSLA","Tesla Inc (Extended Hours)","",""
"47050561440016","13159.34","-0.18","EURd","SWAP","PROCESSED","2023-12-05 22:22:02","","TSLA","Tesla Inc (Extended Hours)","",""
"47050526841085","13159.52","-3.45","EURd","SWAP","PROCESSED","2023-12-05 22:21:29","","Natural Gas","Natural Gas","",""
"47050526840340","13162.97","-3.45","EURd","SWAP","PROCESSED","2023-12-05 22:21:29","","Natural Gas","Natural Gas","",""
"47050522640888","13166.42","-0.26","EURd","SWAP","PROCESSED","2023-12-05 22:21:25","","VIX","Volatility Index","",""
"47050522640579","13166.68","-0.26","EURd","SWAP","PROCESSED","2023-12-05 22:21:25","","VIX","Volatility Index","",""
"47050522640522","13166.94","-0.26","EURd","SWAP","PROCESSED","2023-12-05 22:21:25","","VIX","Volatility Index","",""
"47050522656753","13167.2","-0.26","EURd","SWAP","PROCESSED","2023-12-05 22:21:25","","VIX","Volatility Index","",""
"47050522656707","13167.46","-0.26","EURd","SWAP","PROCESSED","2023-12-05 22:21:25","","VIX","Volatility Index","",""
"47050522656542","13167.72","-0.26","EURd","SWAP","PROCESSED","2023-12-05 22:21:25","","VIX","Volatility Index","",""
"47050436660942","13167.98","-0.35","EURd","SWAP","PROCESSED","2023-12-05 22:20:03","","BABA","Alibaba Group Holding Limited (Extended Hours)","",""
"47050436660826","13168.33","-0.35","EURd","SWAP","PROCESSED","2023-12-05 22:20:03","","BABA","Alibaba Group Holding Limited (Extended Hours)","",""
"47050436660758","13168.68","-0.35","EURd","SWAP","PROCESSED","2023-12-05 22:20:03","","BABA","Alibaba Group Holding Limited (Extended Hours)","",""
"47035590920306","13169.03","0","EURd","TRADE","PROCESSED","2023-12-05 18:24:05","00081081-0055-311e-0000-4cf000132fe8_00081081-0055-311e-0000-00008027050b","BABA","Alibaba Group Holding Limited (Extended Hours)","",""
"47024067068827","13169.03","51.46","EURd","TRADE","PROCESSED","2023-12-05 15:20:55","00513301-0055-311e-0000-4cf0000a0e78_00513301-0055-311e-0000-0000808db832","TSLA","Tesla Inc (Extended Hours)","",""
"46959936167560","13117.57","-0.26","EURd","SWAP","PROCESSED","2023-12-04 22:21:35","","VIX","Volatility Index","",""
"46959936167277","13117.83","-0.26","EURd","SWAP","PROCESSED","2023-12-04 22:21:35","","VIX","Volatility Index","",""
"46959936167211","13118.09","-0.26","EURd","SWAP","PROCESSED","2023-12-04 22:21:35","","VIX","Volatility Index","",""
"46959936167027","13118.35","-0.26","EURd","SWAP","PROCESSED","2023-12-04 22:21:35","","VIX","Volatility Index","",""
"46959936166966","13118.61","-0.26","EURd","SWAP","PROCESSED","2023-12-04 22:21:35","","VIX","Volatility Index","",""
"46959935118255","13118.87","-0.26","EURd","SWAP","PROCESSED","2023-12-04 22:21:34","","VIX","Volatility Index","",""
"46959883743495","13119.13","-0.36","EURd","SWAP","PROCESSED","2023-12-04 22:20:45","","BABA","Alibaba Group Holding Limited (Extended Hours)","",""
"46959883743370","13119.49","-0.36","EURd","SWAP","PROCESSED","2023-12-04 22:20:45","","BABA","Alibaba Group Holding Limited (Extended Hours)","",""
"46959883743297","13119.85","-0.36","EURd","SWAP","PROCESSED","2023-12-04 22:20:45","","BABA","Alibaba Group Holding Limited (Extended Hours)","",""
"46959877442927","13120.21","-0.57","EURd","SWAP","PROCESSED","2023-12-04 22:20:39","","TSLA","Tesla Inc (Extended Hours)","",""
"46959873258461","13120.78","-0.12","EURd","SWAP","PROCESSED","2023-12-04 22:20:35","","TSLA","Tesla Inc (Extended Hours)","",""
"46959873258290","13120.9","-0.18","EURd","SWAP","PROCESSED","2023-12-04 22:20:35","","TSLA","Tesla Inc (Extended Hours)","",""
"46959873258217","13121.08","-0.18","EURd","SWAP","PROCESSED","2023-12-04 22:20:35","","TSLA","Tesla Inc (Extended Hours)","",""
"46959848086425","13121.26","-3.45","EURd","SWAP","PROCESSED","2023-12-04 22:20:11","","Natural Gas","Natural Gas","",""
"46959847036785","13124.71","-3.45","EURd","SWAP","PROCESSED","2023-12-04 22:20:10","","Natural Gas","Natural Gas","",""
"46947077484271","13128.16","12.02","EURd","TRADE","PROCESSED","2023-12-04 18:57:12","00513301-0055-311e-0000-4cef000f0b29_00513301-0055-311e-0000-0000808db289","TSLA","Tesla Inc (Extended Hours)","",""
"46938116346789","13116.14","9.43","EURd","TRADE","PROCESSED","2023-12-04 16:34:46","00016258-0055-311e-0000-4cef0014aef5_00016258-0055-311e-0000-000080530ab1","VIX","Volatility Index","",""
"46938111103895","13106.71","6.93","EURd","TRADE","PROCESSED","2023-12-04 16:34:41","00016258-0055-311e-0000-4cef0014adfc_00016258-0055-311e-0000-0000805309c8","VIX","Volatility Index","",""
"46938026168818","13099.78","3.05","EURd","TRADE","PROCESSED","2023-12-04 16:33:20","00018387-0055-311e-0000-4cef00149c98_00018387-0055-311e-0000-000080ef953e","Natural Gas","Natural Gas","",""
"46938005197159","13096.73","2.77","EURd","TRADE","PROCESSED","2023-12-04 16:33:00","00081081-0055-311e-0000-4cef000cecd4_00081081-0055-311e-0000-000080270448","BABA","Alibaba Group Holding Limited (Extended Hours)","",""
"46914690109627","13093.96","25.13","EURd","TRADE","PROCESSED","2023-12-04 10:22:25","00513301-0055-311e-0000-4cef00069030_00513301-0055-311e-0000-0000808d8bcf","TSLA","Tesla Inc (Extended Hours)","",""
"46869369617025","13068.83","-0.26","EURd","SWAP","PROCESSED","2023-12-03 22:22:04","","VIX","Volatility Index","",""
"46869369616998","13069.09","-0.26","EURd","SWAP","PROCESSED","2023-12-03 22:22:04","","VIX","Volatility Index","",""
"46869368568187","13069.35","-0.26","EURd","SWAP","PROCESSED","2023-12-03 22:22:03","","VIX","Volatility Index","",""
"46869368568027","13069.61","-0.26","EURd","SWAP","PROCESSED","2023-12-03 22:22:03","","VIX","Volatility Index","",""
"46869368568002","13069.87","-0.26","EURd","SWAP","PROCESSED","2023-12-03 22:22:03","","VIX","Volatility Index","",""
"46869368567919","13070.13","-0.26","EURd","SWAP","PROCESSED","2023-12-03 22:22:03","","VIX","Volatility Index","",""
"46869368567901","13070.39","-0.26","EURd","SWAP","PROCESSED","2023-12-03 22:22:03","","VIX","Volatility Index","",""
"46869368567834","13070.65","-0.26","EURd","SWAP","PROCESSED","2023-12-03 22:22:03","","VIX","Volatility Index","",""
"46869331869058","13070.91","-0.58","EURd","SWAP","PROCESSED","2023-12-03 22:21:28","","TSLA","Tesla Inc (Extended Hours)","",""
"46869327668989","13071.49","-0.12","EURd","SWAP","PROCESSED","2023-12-03 22:21:24","","TSLA","Tesla Inc (Extended Hours)","",""
"46869327668862","13071.61","-0.17","EURd","SWAP","PROCESSED","2023-12-03 22:21:24","","TSLA","Tesla Inc (Extended Hours)","",""
"46869327668771","13071.78","-0.17","EURd","SWAP","PROCESSED","2023-12-03 22:21:24","","TSLA","Tesla Inc (Extended Hours)","",""
"46869322418049","13071.95","-0.36","EURd","SWAP","PROCESSED","2023-12-03 22:21:19","","BABA","Alibaba Group Holding Limited (Extended Hours)","",""
"46869322417938","13072.31","-0.36","EURd","SWAP","PROCESSED","2023-12-03 22:21:19","","BABA","Alibaba Group Holding Limited (Extended Hours)","",""
"46869322417849","13072.67","-0.36","EURd","SWAP","PROCESSED","2023-12-03 22:21:19","","BABA","Alibaba Group Holding Limited (Extended Hours)","",""
"46869282579896","13073.03","-3.54","EURd","SWAP","PROCESSED","2023-12-03 22:20:41","","Natural Gas","Natural Gas","",""
"46869281530121","13076.57","-3.54","EURd","SWAP","PROCESSED","2023-12-03 22:20:40","","Natural Gas","Natural Gas","",""
"46778763199038","13080.11","-0.26","EURd","SWAP","PROCESSED","2023-12-02 22:21:55","","VIX","Volatility Index","",""
"46778763199018","13080.37","-0.26","EURd","SWAP","PROCESSED","2023-12-02 22:21:55","","VIX","Volatility Index","",""
"46778763198738","13080.63","-0.26","EURd","SWAP","PROCESSED","2023-12-02 22:21:55","","VIX","Volatility Index","",""
"46778763198563","13080.89","-0.26","EURd","SWAP","PROCESSED","2023-12-02 22:21:55","","VIX","Volatility Index","",""
"46778763198517","13081.15","-0.26","EURd","SWAP","PROCESSED","2023-12-02 22:21:55","","VIX","Volatility Index","",""
"46778763214811","13081.41","-0.26","EURd","SWAP","PROCESSED","2023-12-02 22:21:55","","VIX","Volatility Index","",""
"46778763214778","13081.67","-0.26","EURd","SWAP","PROCESSED","2023-12-02 22:21:55","","VIX","Volatility Index","",""
"46778763214696","13081.93","-0.26","EURd","SWAP","PROCESSED","2023-12-02 22:21:55","","VIX","Volatility Index","",""
"46778684555872","13082.19","-3.54","EURd","SWAP","PROCESSED","2023-12-02 22:20:40","","Natural Gas","Natural Gas","",""
"46778684571074","13085.73","-3.54","EURd","SWAP","PROCESSED","2023-12-02 22:20:40","","Natural Gas","Natural Gas","",""
"46778667784672","13089.27","-0.58","EURd","SWAP","PROCESSED","2023-12-02 22:20:24","","TSLA","Tesla Inc (Extended Hours)","",""
"46778663584525","13089.85","-0.12","EURd","SWAP","PROCESSED","2023-12-02 22:20:20","","TSLA","Tesla Inc (Extended Hours)","",""
"46778663584384","13089.97","-0.17","EURd","SWAP","PROCESSED","2023-12-02 22:20:20","","TSLA","Tesla Inc (Extended Hours)","",""
"46778663584317","13090.14","-0.17","EURd","SWAP","PROCESSED","2023-12-02 22:20:20","","TSLA","Tesla Inc (Extended Hours)","",""
"46778659399594","13090.31","-0.36","EURd","SWAP","PROCESSED","2023-12-02 22:20:16","","BABA","Alibaba Group Holding Limited (Extended Hours)","",""
"46778659399455","13090.67","-0.36","EURd","SWAP","PROCESSED","2023-12-02 22:20:16","","BABA","Alibaba Group Holding Limited (Extended Hours)","",""
"46778659399378","13091.03","-0.36","EURd","SWAP","PROCESSED","2023-12-02 22:20:16","","BABA","Alibaba Group Holding Limited (Extended Hours)","",""
"46597581852421","13091.39","-3.58","EURd","SWAP","PROCESSED","2023-11-30 22:22:07","","Natural Gas","Natural Gas","",""
"46597579754237","13094.97","-3.58","EURd","SWAP","PROCESSED","2023-11-30 22:22:05","","Natural Gas","Natural Gas","",""
"46597567173486","13098.55","-0.36","EURd","SWAP","PROCESSED","2023-11-30 22:21:53","","BABA","Alibaba Group Holding Limited (Extended Hours)","",""
"46597567173449","13098.91","-0.36","EURd","SWAP","PROCESSED","2023-11-30 22:21:53","","BABA","Alibaba Group Holding Limited (Extended Hours)","",""
"46597517900982","13099.27","-0.26","EURd","SWAP","PROCESSED","2023-11-30 22:21:06","","VIX","Volatility Index","",""
"46597516851934","13099.53","-0.26","EURd","SWAP","PROCESSED","2023-11-30 22:21:05","","VIX","Volatility Index","",""
"46597516851880","13099.79","-0.26","EURd","SWAP","PROCESSED","2023-11-30 22:21:05","","VIX","Volatility Index","",""
"46597516851707","13100.05","-0.26","EURd","SWAP","PROCESSED","2023-11-30 22:21:05","","VIX","Volatility Index","",""
"46597516851648","13100.31","-0.26","EURd","SWAP","PROCESSED","2023-11-30 22:21:05","","VIX","Volatility Index","",""
"46597516851517","13100.57","-0.26","EURd","SWAP","PROCESSED","2023-11-30 22:21:05","","VIX","Volatility Index","",""
"46597503216659","13100.83","-0.12","EURd","SWAP","PROCESSED","2023-11-30 22:20:52","","TSLA","Tesla Inc (Extended Hours)","",""
"46597503216521","13100.95","-0.17","EURd","SWAP","PROCESSED","2023-11-30 22:20:52","","TSLA","Tesla Inc (Extended Hours)","",""
"46597503216467","13101.12","-0.17","EURd","SWAP","PROCESSED","2023-11-30 22:20:52","","TSLA","Tesla Inc (Extended Hours)","",""
"46585997194523","13101.29","9.37","EURd","TRADE","PROCESSED","2023-11-30 19:17:59","00513301-0055-311e-0000-4ceb000d5aee_00513301-0055-311e-0000-0000808d82e2","TSLA","Tesla Inc (Extended Hours)","",""
"46538007018954","13091.92","1.34","EURd","TRADE","PROCESSED","2023-11-30 06:35:12","00018509-0055-311e-0000-4ceb000312de_00018509-0055-311e-0000-0000813e1fa0","Oil - Crude","Crude Oil","",""
"46538007018953","13090.58","1.34","EURd","TRADE","PROCESSED","2023-11-30 06:35:12","00018509-0055-311e-0000-4ceb000312dd_00018509-0055-311e-0000-0000813e1fa2","Oil - Crude","Crude Oil","",""
"46538007018952","13089.24","5.4","EURd","TRADE","PROCESSED","2023-11-30 06:35:12","00018509-0055-311e-0000-4ceb000312dc_00018509-0055-311e-0000-0000813e30d9","Oil - Crude","Crude Oil","",""
"46538007018951","13083.84","8.02","EURd","TRADE","PROCESSED","2023-11-30 06:35:12","00018509-0055-311e-0000-4ceb000312db_00018509-0055-311e-0000-0000813e4087","Oil - Crude","Crude Oil","",""
"46506977543657","13075.82","-3.54","EURd","SWAP","PROCESSED","2023-11-29 22:22:00","","Natural Gas","Natural Gas","",""
"46506970211728","13079.36","-0.26","EURd","SWAP","PROCESSED","2023-11-29 22:21:53","","VIX","Volatility Index","",""
"46506969162760","13079.62","-0.26","EURd","SWAP","PROCESSED","2023-11-29 22:21:52","","VIX","Volatility Index","",""
"46506969162708","13079.88","-0.26","EURd","SWAP","PROCESSED","2023-11-29 22:21:52","","VIX","Volatility Index","",""
"46506969162485","13080.14","-0.26","EURd","SWAP","PROCESSED","2023-11-29 22:21:52","","VIX","Volatility Index","",""
"46506969162294","13080.4","-0.26","EURd","SWAP","PROCESSED","2023-11-29 22:21:52","","VIX","Volatility Index","",""
"46506969162199","13080.66","-0.26","EURd","SWAP","PROCESSED","2023-11-29 22:21:52","","VIX","Volatility Index","",""
"46506894716739","13080.92","0.41","EURd","SWAP","PROCESSED","2023-11-29 22:20:41","","Oil - Crude","Crude Oil","",""
"46506894716670","13080.51","0.41","EURd","SWAP","PROCESSED","2023-11-29 22:20:41","","Oil - Crude","Crude Oil","",""
"46506894716545","13080.1","0.41","EURd","SWAP","PROCESSED","2023-11-29 22:20:41","","Oil - Crude","Crude Oil","",""
"46506894716488","13079.69","0.41","EURd","SWAP","PROCESSED","2023-11-29 22:20:41","","Oil - Crude","Crude Oil","",""
"46506881079992","13079.28","-0.12","EURd","SWAP","PROCESSED","2023-11-29 22:20:28","","TSLA","Tesla Inc (Extended Hours)","",""
"46506880031271","13079.4","-0.18","EURd","SWAP","PROCESSED","2023-11-29 22:20:27","","TSLA","Tesla Inc (Extended Hours)","",""
"46506880031189","13079.58","-0.18","EURd","SWAP","PROCESSED","2023-11-29 22:20:27","","TSLA","Tesla Inc (Extended Hours)","",""
"46416372190269","13079.76","0.41","EURd","SWAP","PROCESSED","2023-11-28 22:21:52","","Oil - Crude","Crude Oil","",""
"46416372190216","13079.35","0.41","EURd","SWAP","PROCESSED","2023-11-28 22:21:52","","Oil - Crude","Crude Oil","",""
"46416372190114","13078.94","0.41","EURd","SWAP","PROCESSED","2023-11-28 22:21:52","","Oil - Crude","Crude Oil","",""
"46416372190068","13078.53","0.41","EURd","SWAP","PROCESSED","2023-11-28 22:21:52","","Oil - Crude","Crude Oil","",""
"46416366957541","13078.12","-0.25","EURd","SWAP","PROCESSED","2023-11-28 22:21:47","","VIX","Volatility Index","",""
"46416366956904","13078.37","-0.25","EURd","SWAP","PROCESSED","2023-11-28 22:21:47","","VIX","Volatility Index","",""
"46416366956859","13078.62","-0.25","EURd","SWAP","PROCESSED","2023-11-28 22:21:47","","VIX","Volatility Index","",""
"46416366956545","13078.87","-0.25","EURd","SWAP","PROCESSED","2023-11-28 22:21:47","","VIX","Volatility Index","",""
"46416366956487","13079.12","-0.25","EURd","SWAP","PROCESSED","2023-11-28 22:21:47","","VIX","Volatility Index","",""
"46416365907742","13079.37","-0.25","EURd","SWAP","PROCESSED","2023-11-28 22:21:46","","VIX","Volatility Index","",""
"46416309281747","13079.62","-3.53","EURd","SWAP","PROCESSED","2023-11-28 22:20:52","","Natural Gas","Natural Gas","",""
"46416271526682","13083.15","-0.12","EURd","SWAP","PROCESSED","2023-11-28 22:20:16","","TSLA","Tesla Inc (Extended Hours)","",""
"46416271526570","13083.27","-0.18","EURd","SWAP","PROCESSED","2023-11-28 22:20:16","","TSLA","Tesla Inc (Extended Hours)","",""
"46416271526468","13083.45","-0.18","EURd","SWAP","PROCESSED","2023-11-28 22:20:16","","TSLA","Tesla Inc (Extended Hours)","",""
"46405090566880","13083.63","5.46","EURd","TRADE","PROCESSED","2023-11-28 19:22:33","00513301-0055-311e-0000-4ce9000ca7fb_00513301-0055-311e-0000-0000808bac98","TSLA","Tesla Inc (Extended Hours)","",""
"46405088469721","13078.17","2.55","EURd","TRADE","PROCESSED","2023-11-28 19:22:31","00513301-0055-311e-0000-4ce9000ca7d2_00513301-0055-311e-0000-0000808bac53","TSLA","Tesla Inc (Extended Hours)","",""
"46393755451890","13075.62","34.93","EURd","TRADE","PROCESSED","2023-11-28 16:22:23","00513301-0055-311e-0000-4ce90009775b_00513301-0055-311e-0000-0000808d27ca","TSLA","Tesla Inc (Extended Hours)","",""
"46393691504311","13040.69","21.92","EURd","TRADE","PROCESSED","2023-11-28 16:21:22","00513301-0055-311e-0000-4ce900096fc6_00513301-0055-311e-0000-0000808d3563","TSLA","Tesla Inc (Extended Hours)","",""
"46389490907228","13018.77","0.3","EURd","TRADE","PROCESSED","2023-11-28 15:14:36","00018509-0055-311e-0000-4ce9000b9f9c_00018509-0055-311e-0000-00008140ae38","Oil - Crude","Crude Oil","",""
"46389488810056","13018.47","4.32","EURd","TRADE","PROCESSED","2023-11-28 15:14:34","00018509-0055-311e-0000-4ce9000b9f4d_00018509-0055-311e-0000-0000814250d3","Oil - Crude","Crude Oil","",""
"46325789904537","13014.15","0.4","EURd","SWAP","PROCESSED","2023-11-27 22:22:06","","Oil - Crude","Crude Oil","",""
"46325787805752","13013.75","0.2","EURd","SWAP","PROCESSED","2023-11-27 22:22:04","","Oil - Crude","Crude Oil","",""
"46325786756697","13013.55","0.4","EURd","SWAP","PROCESSED","2023-11-27 22:22:03","","Oil - Crude","Crude Oil","",""
"46325786756667","13013.15","0.4","EURd","SWAP","PROCESSED","2023-11-27 22:22:03","","Oil - Crude","Crude Oil","",""
"46325786756593","13012.75","0.4","EURd","SWAP","PROCESSED","2023-11-27 22:22:03","","Oil - Crude","Crude Oil","",""
"46325786756581","13012.35","0.4","EURd","SWAP","PROCESSED","2023-11-27 22:22:03","","Oil - Crude","Crude Oil","",""
"46325760541847","13011.95","-0.57","EURd","SWAP","PROCESSED","2023-11-27 22:21:38","","TSLA","Tesla Inc (Extended Hours)","",""
"46325758458615","13012.52","-0.28","EURd","SWAP","PROCESSED","2023-11-27 22:21:36","","TSLA","Tesla Inc (Extended Hours)","",""
"46325758458567","13012.8","-0.28","EURd","SWAP","PROCESSED","2023-11-27 22:21:36","","TSLA","Tesla Inc (Extended Hours)","",""
"46325756358113","13013.08","-0.12","EURd","SWAP","PROCESSED","2023-11-27 22:21:34","","TSLA","Tesla Inc (Extended Hours)","",""
"46325756357971","13013.2","-0.17","EURd","SWAP","PROCESSED","2023-11-27 22:21:34","","TSLA","Tesla Inc (Extended Hours)","",""
"46325756357923","13013.37","-0.17","EURd","SWAP","PROCESSED","2023-11-27 22:21:34","","TSLA","Tesla Inc (Extended Hours)","",""
"46325667229227","13013.54","-0.26","EURd","SWAP","PROCESSED","2023-11-27 22:20:09","","VIX","Volatility Index","",""
"46325667228807","13013.8","-0.26","EURd","SWAP","PROCESSED","2023-11-27 22:20:09","","VIX","Volatility Index","",""
"46325667228752","13014.06","-0.26","EURd","SWAP","PROCESSED","2023-11-27 22:20:09","","VIX","Volatility Index","",""
"46325667228584","13014.32","-0.26","EURd","SWAP","PROCESSED","2023-11-27 22:20:09","","VIX","Volatility Index","",""
"46325667228552","13014.58","-0.26","EURd","SWAP","PROCESSED","2023-11-27 22:20:09","","VIX","Volatility Index","",""
"46325667228387","13014.84","-0.26","EURd","SWAP","PROCESSED","2023-11-27 22:20:09","","VIX","Volatility Index","",""
"46320389740888","13015.1","1.28","EURd","TRADE","PROCESSED","2023-11-27 20:56:16","00513301-0055-311e-0000-4ce8000d92c2_00513301-0055-311e-0000-0000808d14e4","TSLA","Tesla Inc (Extended Hours)","",""
"46293566116476","13013.82","36.72","EURd","TRADE","PROCESSED","2023-11-27 13:49:55","00513301-0055-311e-0000-4ce800074228_00513301-0055-311e-0000-0000808c516e","TSLA","Tesla Inc (Extended Hours)","",""
"46235190848879","12977.1","-0.26","EURd","SWAP","PROCESSED","2023-11-26 22:22:04","","VIX","Volatility Index","",""
"46235190848659","12977.36","-0.26","EURd","SWAP","PROCESSED","2023-11-26 22:22:04","","VIX","Volatility Index","",""
"46235190848640","12977.62","-0.26","EURd","SWAP","PROCESSED","2023-11-26 22:22:04","","VIX","Volatility Index","",""
"46235190848554","12977.88","-0.26","EURd","SWAP","PROCESSED","2023-11-26 22:22:04","","VIX","Volatility Index","",""
"46235190848520","12978.14","-0.26","EURd","SWAP","PROCESSED","2023-11-26 22:22:04","","VIX","Volatility Index","",""
"46235190848457","12978.4","-0.26","EURd","SWAP","PROCESSED","2023-11-26 22:22:04","","VIX","Volatility Index","",""
"46235137364772","12978.66","-0.57","EURd","SWAP","PROCESSED","2023-11-26 22:21:13","","TSLA","Tesla Inc (Extended Hours)","",""
"46235136314694","12979.23","-0.28","EURd","SWAP","PROCESSED","2023-11-26 22:21:12","","TSLA","Tesla Inc (Extended Hours)","",""
"46235136314597","12979.51","-0.28","EURd","SWAP","PROCESSED","2023-11-26 22:21:12","","TSLA","Tesla Inc (Extended Hours)","",""
"46235134230428","12979.79","-0.12","EURd","SWAP","PROCESSED","2023-11-26 22:21:10","","TSLA","Tesla Inc (Extended Hours)","",""
"46235134230292","12979.91","-0.17","EURd","SWAP","PROCESSED","2023-11-26 22:21:10","","TSLA","Tesla Inc (Extended Hours)","",""
"46235134230236","12980.08","-0.17","EURd","SWAP","PROCESSED","2023-11-26 22:21:10","","TSLA","Tesla Inc (Extended Hours)","",""
"46235099612112","12980.25","0.2","EURd","SWAP","PROCESSED","2023-11-26 22:20:37","","Oil - Crude","Crude Oil","",""
"46235098578472","12980.05","0.4","EURd","SWAP","PROCESSED","2023-11-26 22:20:36","","Oil - Crude","Crude Oil","",""
"46235098578377","12979.65","0.4","EURd","SWAP","PROCESSED","2023-11-26 22:20:36","","Oil - Crude","Crude Oil","",""
"46235098578267","12979.25","0.4","EURd","SWAP","PROCESSED","2023-11-26 22:20:36","","Oil - Crude","Crude Oil","",""
"46235098578181","12978.85","0.4","EURd","SWAP","PROCESSED","2023-11-26 22:20:36","","Oil - Crude","Crude Oil","",""
"46144537263569","12978.45","-0.57","EURd","SWAP","PROCESSED","2023-11-25 22:21:10","","TSLA","Tesla Inc (Extended Hours)","",""
"46144536213467","12979.02","-0.28","EURd","SWAP","PROCESSED","2023-11-25 22:21:09","","TSLA","Tesla Inc (Extended Hours)","",""
"46144536213375","12979.3","-0.28","EURd","SWAP","PROCESSED","2023-11-25 22:21:09","","TSLA","Tesla Inc (Extended Hours)","",""
"46144534112677","12979.58","-0.12","EURd","SWAP","PROCESSED","2023-11-25 22:21:07","","TSLA","Tesla Inc (Extended Hours)","",""
"46144534112563","12979.7","-0.17","EURd","SWAP","PROCESSED","2023-11-25 22:21:07","","TSLA","Tesla Inc (Extended Hours)","",""
"46144534112493","12979.87","-0.17","EURd","SWAP","PROCESSED","2023-11-25 22:21:07","","TSLA","Tesla Inc (Extended Hours)","",""
"46144509991967","12980.04","-0.26","EURd","SWAP","PROCESSED","2023-11-25 22:20:44","","VIX","Volatility Index","",""
"46144509991445","12980.3","-0.26","EURd","SWAP","PROCESSED","2023-11-25 22:20:44","","VIX","Volatility Index","",""
"46144509991375","12980.56","-0.26","EURd","SWAP","PROCESSED","2023-11-25 22:20:44","","VIX","Volatility Index","",""
"46144508942582","12980.82","-0.26","EURd","SWAP","PROCESSED","2023-11-25 22:20:43","","VIX","Volatility Index","",""
"46144508942519","12981.08","-0.26","EURd","SWAP","PROCESSED","2023-11-25 22:20:43","","VIX","Volatility Index","",""
"46144508942414","12981.34","-0.26","EURd","SWAP","PROCESSED","2023-11-25 22:20:43","","VIX","Volatility Index","",""
"46144490071823","12981.6","0.2","EURd","SWAP","PROCESSED","2023-11-25 22:20:25","","Oil - Crude","Crude Oil","",""
"46144489021934","12981.4","0.4","EURd","SWAP","PROCESSED","2023-11-25 22:20:24","","Oil - Crude","Crude Oil","",""
"46144489021875","12981","0.4","EURd","SWAP","PROCESSED","2023-11-25 22:20:24","","Oil - Crude","Crude Oil","",""
"46144489021749","12980.6","0.4","EURd","SWAP","PROCESSED","2023-11-25 22:20:24","","Oil - Crude","Crude Oil","",""
"46144489021683","12980.2","0.4","EURd","SWAP","PROCESSED","2023-11-25 22:20:24","","Oil - Crude","Crude Oil","",""
"46053895197604","12979.8","-0.57","EURd","SWAP","PROCESSED","2023-11-24 22:20:27","","TSLA","Tesla Inc (Extended Hours)","",""
"46053894147465","12980.37","-0.28","EURd","SWAP","PROCESSED","2023-11-24 22:20:26","","TSLA","Tesla Inc (Extended Hours)","",""
"46053894147410","12980.65","-0.28","EURd","SWAP","PROCESSED","2023-11-24 22:20:26","","TSLA","Tesla Inc (Extended Hours)","",""
"46053891014414","12980.93","-0.12","EURd","SWAP","PROCESSED","2023-11-24 22:20:23","","TSLA","Tesla Inc (Extended Hours)","",""
"46053891014243","12981.05","-0.17","EURd","SWAP","PROCESSED","2023-11-24 22:20:23","","TSLA","Tesla Inc (Extended Hours)","",""
"46053891014169","12981.22","-0.17","EURd","SWAP","PROCESSED","2023-11-24 22:20:23","","TSLA","Tesla Inc (Extended Hours)","",""
"46053871079858","12981.39","-0.26","EURd","SWAP","PROCESSED","2023-11-24 22:20:04","","VIX","Volatility Index","",""
"46053871079402","12981.65","-0.26","EURd","SWAP","PROCESSED","2023-11-24 22:20:04","","VIX","Volatility Index","",""
"46053871079337","12981.91","-0.26","EURd","SWAP","PROCESSED","2023-11-24 22:20:04","","VIX","Volatility Index","",""
"46053871079139","12982.17","-0.26","EURd","SWAP","PROCESSED","2023-11-24 22:20:04","","VIX","Volatility Index","",""
"46053871079069","12982.43","-0.26","EURd","SWAP","PROCESSED","2023-11-24 22:20:04","","VIX","Volatility Index","",""
"46053871078952","12982.69","-0.26","EURd","SWAP","PROCESSED","2023-11-24 22:20:04","","VIX","Volatility Index","",""
"45963348564211","12982.95","-0.27","EURd","SWAP","PROCESSED","2023-11-23 22:21:15","","VIX","Volatility Index","",""
"45963348563756","12983.22","-0.27","EURd","SWAP","PROCESSED","2023-11-23 22:21:15","","VIX","Volatility Index","",""
"45963348563691","12983.49","-0.27","EURd","SWAP","PROCESSED","2023-11-23 22:21:15","","VIX","Volatility Index","",""
"45963347514908","12983.76","-0.27","EURd","SWAP","PROCESSED","2023-11-23 22:21:14","","VIX","Volatility Index","",""
"45963347514844","12984.03","-0.27","EURd","SWAP","PROCESSED","2023-11-23 22:21:14","","VIX","Volatility Index","",""
"45963347514771","12984.3","-0.27","EURd","SWAP","PROCESSED","2023-11-23 22:21:14","","VIX","Volatility Index","",""
"45963301376913","12984.57","-0.57","EURd","SWAP","PROCESSED","2023-11-23 22:20:30","","TSLA","Tesla Inc (Extended Hours)","",""
"45963300326669","12985.14","-0.28","EURd","SWAP","PROCESSED","2023-11-23 22:20:29","","TSLA","Tesla Inc (Extended Hours)","",""
"45963300326585","12985.42","-0.28","EURd","SWAP","PROCESSED","2023-11-23 22:20:29","","TSLA","Tesla Inc (Extended Hours)","",""
"45963297193459","12985.7","-0.12","EURd","SWAP","PROCESSED","2023-11-23 22:20:26","","TSLA","Tesla Inc (Extended Hours)","",""
"45963297193328","12985.82","-0.17","EURd","SWAP","PROCESSED","2023-11-23 22:20:26","","TSLA","Tesla Inc (Extended Hours)","",""
"45963297193268","12985.99","-0.17","EURd","SWAP","PROCESSED","2023-11-23 22:20:26","","TSLA","Tesla Inc (Extended Hours)","",""
"45872762077466","12986.16","-0.57","EURd","SWAP","PROCESSED","2023-11-22 22:21:25","","TSLA","Tesla Inc (Extended Hours)","",""
"45872759994305","12986.73","-0.28","EURd","SWAP","PROCESSED","2023-11-22 22:21:23","","TSLA","Tesla Inc (Extended Hours)","",""
"45872759994236","12987.01","-0.28","EURd","SWAP","PROCESSED","2023-11-22 22:21:23","","TSLA","Tesla Inc (Extended Hours)","",""
"45872755793822","12987.29","-0.12","EURd","SWAP","PROCESSED","2023-11-22 22:21:19","","TSLA","Tesla Inc (Extended Hours)","",""
"45872755793699","12987.41","-0.17","EURd","SWAP","PROCESSED","2023-11-22 22:21:19","","TSLA","Tesla Inc (Extended Hours)","",""
"45872755793631","12987.58","-0.17","EURd","SWAP","PROCESSED","2023-11-22 22:21:19","","TSLA","Tesla Inc (Extended Hours)","",""
"45872720137933","12987.75","-0.27","EURd","SWAP","PROCESSED","2023-11-22 22:20:45","","VIX","Volatility Index","",""
"45872720137450","12988.02","-0.27","EURd","SWAP","PROCESSED","2023-11-22 22:20:45","","VIX","Volatility Index","",""
"45872720137386","12988.29","-0.27","EURd","SWAP","PROCESSED","2023-11-22 22:20:45","","VIX","Volatility Index","",""
"45872720137205","12988.56","-0.27","EURd","SWAP","PROCESSED","2023-11-22 22:20:45","","VIX","Volatility Index","",""
"45872720137080","12988.83","-0.27","EURd","SWAP","PROCESSED","2023-11-22 22:20:45","","VIX","Volatility Index","",""
"45872720136961","12989.1","-0.27","EURd","SWAP","PROCESSED","2023-11-22 22:20:45","","VIX","Volatility Index","",""
"45872713853143","12989.37","0.2","EURd","SWAP","PROCESSED","2023-11-22 22:20:39","","Oil - Crude","Crude Oil","",""
"45872712803005","12989.17","0.41","EURd","SWAP","PROCESSED","2023-11-22 22:20:38","","Oil - Crude","Crude Oil","",""
"45872712802935","12988.76","0.41","EURd","SWAP","PROCESSED","2023-11-22 22:20:38","","Oil - Crude","Crude Oil","",""
"45872712802801","12988.35","0.41","EURd","SWAP","PROCESSED","2023-11-22 22:20:38","","Oil - Crude","Crude Oil","",""
"45872712802732","12987.94","0.41","EURd","SWAP","PROCESSED","2023-11-22 22:20:38","","Oil - Crude","Crude Oil","",""
"45848936342473","12987.53","16.75","EURd","TRADE","PROCESSED","2023-11-22 16:02:43","0004d68e-0055-311e-0000-4ce3000a391b_0004d68e-0055-311e-0000-0000802a3f0f","AMZN","Amazon.com Inc (Extended Hours)","",""
"45848936342472","12970.78","2.02","EURd","TRADE","PROCESSED","2023-11-22 16:02:43","0004d68e-0055-311e-0000-4ce3000a391a_0004d68e-0055-311e-0000-0000802a3d20","AMZN","Amazon.com Inc (Extended Hours)","",""
"45837258348996","12968.76","2.11","EURd","TRADE","PROCESSED","2023-11-22 12:57:06","0004d68e-0055-311e-0000-4ce300012bf2_0004d68e-0055-311e-0000-0000802b07d4","AMZN","Amazon.com Inc (Extended Hours)","",""
"45837197531409","12966.65","3.8","EURd","TRADE","PROCESSED","2023-11-22 12:56:08","00513301-0055-311e-0000-4ce30006971f_00513301-0055-311e-0000-0000808c3f2e","TSLA","Tesla Inc (Extended Hours)","",""
"45782160923361","12962.85","0.41","EURd","SWAP","PROCESSED","2023-11-21 22:21:21","","Oil - Crude","Crude Oil","",""
"45782160923298","12962.44","0.41","EURd","SWAP","PROCESSED","2023-11-21 22:21:21","","Oil - Crude","Crude Oil","",""
"45782160923193","12962.03","0.41","EURd","SWAP","PROCESSED","2023-11-21 22:21:21","","Oil - Crude","Crude Oil","",""
"45782160923140","12961.62","0.41","EURd","SWAP","PROCESSED","2023-11-21 22:21:21","","Oil - Crude","Crude Oil","",""
"45782143104575","12961.21","-0.27","EURd","SWAP","PROCESSED","2023-11-21 22:21:04","","VIX","Volatility Index","",""
"45782143104509","12961.48","-0.27","EURd","SWAP","PROCESSED","2023-11-21 22:21:04","","VIX","Volatility Index","",""
"45782143104293","12961.75","-0.27","EURd","SWAP","PROCESSED","2023-11-21 22:21:04","","VIX","Volatility Index","",""
"45782143104176","12962.02","-0.27","EURd","SWAP","PROCESSED","2023-11-21 22:21:04","","VIX","Volatility Index","",""
"45782143104073","12962.29","-0.27","EURd","SWAP","PROCESSED","2023-11-21 22:21:04","","VIX","Volatility Index","",""
"45782142053567","12962.56","-0.35","EURd","SWAP","PROCESSED","2023-11-21 22:21:03","","AMZN","Amazon.com Inc (Extended Hours)","",""
"45782142053388","12962.91","-0.35","EURd","SWAP","PROCESSED","2023-11-21 22:21:03","","AMZN","Amazon.com Inc (Extended Hours)","",""
"45782135752736","12963.26","-0.29","EURd","SWAP","PROCESSED","2023-11-21 22:20:57","","TSLA","Tesla Inc (Extended Hours)","",""
"45782135752677","12963.55","-0.29","EURd","SWAP","PROCESSED","2023-11-21 22:20:57","","TSLA","Tesla Inc (Extended Hours)","",""
"45782132619053","12963.84","-0.12","EURd","SWAP","PROCESSED","2023-11-21 22:20:54","","TSLA","Tesla Inc (Extended Hours)","",""
"45782132618949","12963.96","-0.17","EURd","SWAP","PROCESSED","2023-11-21 22:20:54","","TSLA","Tesla Inc (Extended Hours)","",""
"45782132618846","12964.13","-0.17","EURd","SWAP","PROCESSED","2023-11-21 22:20:54","","TSLA","Tesla Inc (Extended Hours)","",""
"45769350468191","12964.3","15.22","EURd","TRADE","PROCESSED","2023-11-21 18:57:44","00513301-0055-311e-0000-4ce2000ccfee_00513301-0055-311e-0000-0000808c1015","TSLA","Tesla Inc (Extended Hours)","",""
"45769346273877","12949.08","15.29","EURd","TRADE","PROCESSED","2023-11-21 18:57:40","00513301-0055-311e-0000-4ce2000ccfce_00513301-0055-311e-0000-0000808c101e","TSLA","Tesla Inc (Extended Hours)","",""
"45691605900541","12933.79","0.41","EURd","SWAP","PROCESSED","2023-11-20 22:22:01","","Oil - Crude","Crude Oil","",""
"45691605900508","12933.38","0.41","EURd","SWAP","PROCESSED","2023-11-20 22:22:01","","Oil - Crude","Crude Oil","",""
"45691605900435","12932.97","0.41","EURd","SWAP","PROCESSED","2023-11-20 22:22:01","","Oil - Crude","Crude Oil","",""
"45691605900410","12932.56","0.41","EURd","SWAP","PROCESSED","2023-11-20 22:22:01","","Oil - Crude","Crude Oil","",""
"45691558716051","12932.15","-0.36","EURd","SWAP","PROCESSED","2023-11-20 22:21:16","","AMZN","Amazon.com Inc (Extended Hours)","",""
"45691558715878","12932.51","-0.36","EURd","SWAP","PROCESSED","2023-11-20 22:21:16","","AMZN","Amazon.com Inc (Extended Hours)","",""
"45691545080858","12932.87","-0.12","EURd","SWAP","PROCESSED","2023-11-20 22:21:03","","TSLA","Tesla Inc (Extended Hours)","",""
"45691545080796","12932.99","-0.12","EURd","SWAP","PROCESSED","2023-11-20 22:21:03","","TSLA","Tesla Inc (Extended Hours)","",""
"45691544031417","12933.11","-0.28","EURd","SWAP","PROCESSED","2023-11-20 22:21:02","","TSLA","Tesla Inc (Extended Hours)","",""
"45691544031343","12933.39","-0.28","EURd","SWAP","PROCESSED","2023-11-20 22:21:02","","TSLA","Tesla Inc (Extended Hours)","",""
"45691540897477","12933.67","-0.12","EURd","SWAP","PROCESSED","2023-11-20 22:20:59","","TSLA","Tesla Inc (Extended Hours)","",""
"45691540897394","12933.79","-0.17","EURd","SWAP","PROCESSED","2023-11-20 22:20:59","","TSLA","Tesla Inc (Extended Hours)","",""
"45691540896841","12933.96","-0.17","EURd","SWAP","PROCESSED","2023-11-20 22:20:59","","TSLA","Tesla Inc (Extended Hours)","",""
"45691514677780","12934.13","-0.27","EURd","SWAP","PROCESSED","2023-11-20 22:20:34","","VIX","Volatility Index","",""
"45691514677688","12934.4","-0.27","EURd","SWAP","PROCESSED","2023-11-20 22:20:34","","VIX","Volatility Index","",""
"45691513628912","12934.67","-0.27","EURd","SWAP","PROCESSED","2023-11-20 22:20:33","","VIX","Volatility Index","",""
"45691513628765","12934.94","-0.27","EURd","SWAP","PROCESSED","2023-11-20 22:20:33","","VIX","Volatility Index","",""
"45691513628646","12935.21","-0.27","EURd","SWAP","PROCESSED","2023-11-20 22:20:33","","VIX","Volatility Index","",""
"45600985870270","12935.48","-0.28","EURd","SWAP","PROCESSED","2023-11-19 22:21:39","","TSLA","Tesla Inc (Extended Hours)","",""
"45600985870218","12935.76","-0.28","EURd","SWAP","PROCESSED","2023-11-19 22:21:39","","TSLA","Tesla Inc (Extended Hours)","",""
"45600982720152","12936.04","-0.12","EURd","SWAP","PROCESSED","2023-11-19 22:21:36","","TSLA","Tesla Inc (Extended Hours)","",""
"45600982719995","12936.16","-0.17","EURd","SWAP","PROCESSED","2023-11-19 22:21:36","","TSLA","Tesla Inc (Extended Hours)","",""
"45600982719875","12936.33","-0.17","EURd","SWAP","PROCESSED","2023-11-19 22:21:36","","TSLA","Tesla Inc (Extended Hours)","",""
"45600962800870","12936.5","-0.35","EURd","SWAP","PROCESSED","2023-11-19 22:21:17","","AMZN","Amazon.com Inc (Extended Hours)","",""
"45600962800704","12936.85","-0.35","EURd","SWAP","PROCESSED","2023-11-19 22:21:17","","AMZN","Amazon.com Inc (Extended Hours)","",""
"45600929247265","12937.2","0.4","EURd","SWAP","PROCESSED","2023-11-19 22:20:45","","Oil - Crude","Crude Oil","",""
"45600929247169","12936.8","0.4","EURd","SWAP","PROCESSED","2023-11-19 22:20:45","","Oil - Crude","Crude Oil","",""
"45600929247031","12936.4","0.4","EURd","SWAP","PROCESSED","2023-11-19 22:20:45","","Oil - Crude","Crude Oil","",""
"45600929246988","12936","0.4","EURd","SWAP","PROCESSED","2023-11-19 22:20:45","","Oil - Crude","Crude Oil","",""
"45600908277135","12935.6","-0.27","EURd","SWAP","PROCESSED","2023-11-19 22:20:25","","VIX","Volatility Index","",""
"45600908276984","12935.87","-0.27","EURd","SWAP","PROCESSED","2023-11-19 22:20:25","","VIX","Volatility Index","",""
"45600908276758","12936.14","-0.27","EURd","SWAP","PROCESSED","2023-11-19 22:20:25","","VIX","Volatility Index","",""
"45600908276645","12936.41","-0.27","EURd","SWAP","PROCESSED","2023-11-19 22:20:25","","VIX","Volatility Index","",""
"45600907227965","12936.68","-0.27","EURd","SWAP","PROCESSED","2023-11-19 22:20:24","","VIX","Volatility Index","",""
"45510352205478","12936.95","-0.35","EURd","SWAP","PROCESSED","2023-11-18 22:21:04","","AMZN","Amazon.com Inc (Extended Hours)","",""
"45510351156701","12937.3","-0.35","EURd","SWAP","PROCESSED","2023-11-18 22:21:03","","AMZN","Amazon.com Inc (Extended Hours)","",""
"45510344855547","12937.65","-0.28","EURd","SWAP","PROCESSED","2023-11-18 22:20:57","","TSLA","Tesla Inc (Extended Hours)","",""
"45510344855495","12937.93","-0.28","EURd","SWAP","PROCESSED","2023-11-18 22:20:57","","TSLA","Tesla Inc (Extended Hours)","",""
"45510341721681","12938.21","-0.12","EURd","SWAP","PROCESSED","2023-11-18 22:20:54","","TSLA","Tesla Inc (Extended Hours)","",""
"45510341721549","12938.33","-0.17","EURd","SWAP","PROCESSED","2023-11-18 22:20:54","","TSLA","Tesla Inc (Extended Hours)","",""
"45510341721418","12938.5","-0.17","EURd","SWAP","PROCESSED","2023-11-18 22:20:54","","TSLA","Tesla Inc (Extended Hours)","",""
"45510305017246","12938.67","0.4","EURd","SWAP","PROCESSED","2023-11-18 22:20:19","","Oil - Crude","Crude Oil","",""
"45510305017107","12938.27","0.4","EURd","SWAP","PROCESSED","2023-11-18 22:20:19","","Oil - Crude","Crude Oil","",""
"45510305016945","12937.87","0.4","EURd","SWAP","PROCESSED","2023-11-18 22:20:19","","Oil - Crude","Crude Oil","",""
"45510305016879","12937.47","0.4","EURd","SWAP","PROCESSED","2023-11-18 22:20:19","","Oil - Crude","Crude Oil","",""
"45510287185901","12937.07","-0.27","EURd","SWAP","PROCESSED","2023-11-18 22:20:02","","VIX","Volatility Index","",""
"45510287185758","12937.34","-0.27","EURd","SWAP","PROCESSED","2023-11-18 22:20:02","","VIX","Volatility Index","",""
"45510287185555","12937.61","-0.27","EURd","SWAP","PROCESSED","2023-11-18 22:20:02","","VIX","Volatility Index","",""
"45510287185402","12937.88","-0.27","EURd","SWAP","PROCESSED","2023-11-18 22:20:02","","VIX","Volatility Index","",""
"45510287185273","12938.15","-0.27","EURd","SWAP","PROCESSED","2023-11-18 22:20:02","","VIX","Volatility Index","",""
"45419812904194","12938.42","0.4","EURd","SWAP","PROCESSED","2023-11-17 22:21:59","","Oil - Crude","Crude Oil","",""
"45419812904124","12938.02","0.4","EURd","SWAP","PROCESSED","2023-11-17 22:21:59","","Oil - Crude","Crude Oil","",""
"45419811855481","12937.62","0.4","EURd","SWAP","PROCESSED","2023-11-17 22:21:58","","Oil - Crude","Crude Oil","",""
"45419811855445","12937.22","0.4","EURd","SWAP","PROCESSED","2023-11-17 22:21:58","","Oil - Crude","Crude Oil","",""
"45419805573066","12936.82","-0.27","EURd","SWAP","PROCESSED","2023-11-17 22:21:52","","VIX","Volatility Index","",""
"45419805572995","12937.09","-0.27","EURd","SWAP","PROCESSED","2023-11-17 22:21:52","","VIX","Volatility Index","",""
"45419805572839","12937.36","-0.27","EURd","SWAP","PROCESSED","2023-11-17 22:21:52","","VIX","Volatility Index","",""
"45419804524173","12937.63","-0.27","EURd","SWAP","PROCESSED","2023-11-17 22:21:51","","VIX","Volatility Index","",""
"45419804524080","12937.9","-0.27","EURd","SWAP","PROCESSED","2023-11-17 22:21:51","","VIX","Volatility Index","",""
"45419789841295","12938.17","-0.28","EURd","SWAP","PROCESSED","2023-11-17 22:21:37","","TSLA","Tesla Inc (Extended Hours)","",""
"45419789841237","12938.45","-0.28","EURd","SWAP","PROCESSED","2023-11-17 22:21:37","","TSLA","Tesla Inc (Extended Hours)","",""
"45419786691054","12938.73","-0.12","EURd","SWAP","PROCESSED","2023-11-17 22:21:34","","TSLA","Tesla Inc (Extended Hours)","",""
"45419786690930","12938.85","-0.17","EURd","SWAP","PROCESSED","2023-11-17 22:21:34","","TSLA","Tesla Inc (Extended Hours)","",""
"45419786690793","12939.02","-0.17","EURd","SWAP","PROCESSED","2023-11-17 22:21:34","","TSLA","Tesla Inc (Extended Hours)","",""
"45419699661738","12939.19","-0.35","EURd","SWAP","PROCESSED","2023-11-17 22:20:11","","AMZN","Amazon.com Inc (Extended Hours)","",""
"45419699661542","12939.54","-0.35","EURd","SWAP","PROCESSED","2023-11-17 22:20:11","","AMZN","Amazon.com Inc (Extended Hours)","",""
"45396009186314","12939.89","2.54","EURd","TRADE","PROCESSED","2023-11-17 16:03:38","00513301-0055-311e-0000-4cde0009fb38_00513301-0055-311e-0000-0000808bd9a7","TSLA","Tesla Inc (Extended Hours)","",""
"45396002894809","12937.35","6.38","EURd","TRADE","PROCESSED","2023-11-17 16:03:32","00018509-0055-311e-0000-4cde000ea32a_00018509-0055-311e-0000-0000813ed5be","Oil - Crude","Crude Oil","",""
"45371484034767","12930.97","4.29","EURd","TRADE","PROCESSED","2023-11-17 09:33:49","00396101-0055-311e-0000-4cde000097f9_00396101-0055-311e-0000-00008027655b","NVDA","NVIDIA Corp (Extended Hours)","",""
"45329214888713","12926.68","-0.35","EURd","SWAP","PROCESSED","2023-11-16 22:21:58","","AMZN","Amazon.com Inc (Extended Hours)","",""
"45329214888619","12927.03","-0.35","EURd","SWAP","PROCESSED","2023-11-16 22:21:58","","AMZN","Amazon.com Inc (Extended Hours)","",""
"45329206507980","12927.38","-0.29","EURd","SWAP","PROCESSED","2023-11-16 22:21:50","","TSLA","Tesla Inc (Extended Hours)","",""
"45329206507930","12927.67","-0.29","EURd","SWAP","PROCESSED","2023-11-16 22:21:50","","TSLA","Tesla Inc (Extended Hours)","",""
"45329204407160","12927.96","-0.12","EURd","SWAP","PROCESSED","2023-11-16 22:21:48","","TSLA","Tesla Inc (Extended Hours)","",""
"45329203358509","12928.08","-0.18","EURd","SWAP","PROCESSED","2023-11-16 22:21:47","","TSLA","Tesla Inc (Extended Hours)","",""
"45329203358387","12928.26","-0.18","EURd","SWAP","PROCESSED","2023-11-16 22:21:47","","TSLA","Tesla Inc (Extended Hours)","",""
"45329186573236","12928.44","-0.24","EURd","SWAP","PROCESSED","2023-11-16 22:21:31","","NVDA","NVIDIA Corp (Extended Hours)","",""
"45329175039058","12928.68","-0.27","EURd","SWAP","PROCESSED","2023-11-16 22:21:20","","VIX","Volatility Index","",""
"45329175038813","12928.95","-0.27","EURd","SWAP","PROCESSED","2023-11-16 22:21:20","","VIX","Volatility Index","",""
"45329175038555","12929.22","-0.27","EURd","SWAP","PROCESSED","2023-11-16 22:21:20","","VIX","Volatility Index","",""
"45329175038422","12929.49","-0.27","EURd","SWAP","PROCESSED","2023-11-16 22:21:20","","VIX","Volatility Index","",""
"45329175038307","12929.76","-0.27","EURd","SWAP","PROCESSED","2023-11-16 22:21:20","","VIX","Volatility Index","",""
"45329161419026","12930.03","0.4","EURd","SWAP","PROCESSED","2023-11-16 22:21:07","","Oil - Crude","Crude Oil","",""
"45329161418895","12929.63","0.4","EURd","SWAP","PROCESSED","2023-11-16 22:21:07","","Oil - Crude","Crude Oil","",""
"45329160370206","12929.23","0.4","EURd","SWAP","PROCESSED","2023-11-16 22:21:06","","Oil - Crude","Crude Oil","",""
"45329160370163","12928.83","0.4","EURd","SWAP","PROCESSED","2023-11-16 22:21:06","","Oil - Crude","Crude Oil","",""
"45238612673221","12928.43","-0.24","EURd","SWAP","PROCESSED","2023-11-15 22:21:53","","NVDA","NVIDIA Corp (Extended Hours)","",""
"45238603241970","12928.67","-0.35","EURd","SWAP","PROCESSED","2023-11-15 22:21:44","","AMZN","Amazon.com Inc (Extended Hours)","",""
"45238603241836","12929.02","-0.35","EURd","SWAP","PROCESSED","2023-11-15 22:21:44","","AMZN","Amazon.com Inc (Extended Hours)","",""
"45238601141345","12929.37","0.41","EURd","SWAP","PROCESSED","2023-11-15 22:21:42","","Oil - Crude","Crude Oil","",""
"45238601141040","12928.96","0.41","EURd","SWAP","PROCESSED","2023-11-15 22:21:42","","Oil - Crude","Crude Oil","",""
"45238600092300","12928.55","0.41","EURd","SWAP","PROCESSED","2023-11-15 22:21:41","","Oil - Crude","Crude Oil","",""
"45238600092242","12928.14","0.41","EURd","SWAP","PROCESSED","2023-11-15 22:21:41","","Oil - Crude","Crude Oil","",""
"45238592757062","12927.73","-0.28","EURd","SWAP","PROCESSED","2023-11-15 22:21:34","","VIX","Volatility Index","",""
"45238592756833","12928.01","-0.28","EURd","SWAP","PROCESSED","2023-11-15 22:21:34","","VIX","Volatility Index","",""
"45238592756610","12928.29","-0.28","EURd","SWAP","PROCESSED","2023-11-15 22:21:34","","VIX","Volatility Index","",""
"45238592756470","12928.57","-0.28","EURd","SWAP","PROCESSED","2023-11-15 22:21:34","","VIX","Volatility Index","",""
"45238592756278","12928.85","-0.28","EURd","SWAP","PROCESSED","2023-11-15 22:21:34","","VIX","Volatility Index","",""
"45238543481259","12929.13","-0.29","EURd","SWAP","PROCESSED","2023-11-15 22:20:47","","TSLA","Tesla Inc (Extended Hours)","",""
"45238543481192","12929.42","-0.29","EURd","SWAP","PROCESSED","2023-11-15 22:20:47","","TSLA","Tesla Inc (Extended Hours)","",""
"45238539281693","12929.71","-0.12","EURd","SWAP","PROCESSED","2023-11-15 22:20:43","","TSLA","Tesla Inc (Extended Hours)","",""
"45238539281561","12929.83","-0.18","EURd","SWAP","PROCESSED","2023-11-15 22:20:43","","TSLA","Tesla Inc (Extended Hours)","",""
"45238539281429","12930.01","-0.18","EURd","SWAP","PROCESSED","2023-11-15 22:20:43","","TSLA","Tesla Inc (Extended Hours)","",""
"45216568468143","12930.19","8.38","EURd","TRADE","PROCESSED","2023-11-15 16:31:30","00513301-0055-311e-0000-4cdc000b8e09_00513301-0055-311e-0000-0000808ba846","TSLA","Tesla Inc (Extended Hours)","",""
"45213381840533","12921.81","16.49","EURd","TRADE","PROCESSED","2023-11-15 15:40:51","00513301-0055-311e-0000-4cdc000a8a15_00513301-0055-311e-0000-0000808ba75e","TSLA","Tesla Inc (Extended Hours)","",""
"45212519920722","12905.32","18.81","EURd","TRADE","PROCESSED","2023-11-15 15:27:09","00513301-0055-311e-0000-4cdc000a3e5d_00513301-0055-311e-0000-0000808b9886","TSLA","Tesla Inc (Extended Hours)","",""
"45212196956677","12886.51","4.98","EURd","TRADE","PROCESSED","2023-11-15 15:22:01","004433cd-0055-311e-0000-4cdc0007b1ed_004433cd-0055-311e-0000-00008024011b","QCOM","QUALCOMM Inc (Extended Hours)","",""
"45210718455061","12881.53","4.98","EURd","TRADE","PROCESSED","2023-11-15 14:58:31","0024e503-0055-311e-0000-4cdc0005ad2c_0024e503-0055-311e-0000-000080240631","INTC","Intel Corp (Extended Hours)","",""
"45189415587760","12876.55","22.11","EURd","TRADE","PROCESSED","2023-11-15 09:19:55","00081081-0055-311e-0000-4cdc00011758_00081081-0055-311e-0000-0000802504f2","BABA","Alibaba Group Holding Limited (Extended Hours)","",""
"45148019911435","12854.44","-0.28","EURd","SWAP","PROCESSED","2023-11-14 22:21:57","","VIX","Volatility Index","",""
"45148019911279","12854.72","-0.28","EURd","SWAP","PROCESSED","2023-11-14 22:21:57","","VIX","Volatility Index","",""
"45148018862503","12855","-0.28","EURd","SWAP","PROCESSED","2023-11-14 22:21:56","","VIX","Volatility Index","",""
"45148018862417","12855.28","-0.28","EURd","SWAP","PROCESSED","2023-11-14 22:21:56","","VIX","Volatility Index","",""
"45148018862282","12855.56","-0.28","EURd","SWAP","PROCESSED","2023-11-14 22:21:56","","VIX","Volatility Index","",""
"45147963293389","12855.84","-0.36","EURd","SWAP","PROCESSED","2023-11-14 22:21:03","","AMZN","Amazon.com Inc (Extended Hours)","",""
"45147956993500","12856.2","-0.41","EURd","SWAP","PROCESSED","2023-11-14 22:20:57","","BABA","Alibaba Group Holding Limited (Extended Hours)","",""
"45147939174927","12856.61","-0.12","EURd","SWAP","PROCESSED","2023-11-14 22:20:40","","TSLA","Tesla Inc (Extended Hours)","",""
"45147938126214","12856.73","-0.17","EURd","SWAP","PROCESSED","2023-11-14 22:20:39","","TSLA","Tesla Inc (Extended Hours)","",""
"45147938126088","12856.9","-0.17","EURd","SWAP","PROCESSED","2023-11-14 22:20:39","","TSLA","Tesla Inc (Extended Hours)","",""
"45147924490916","12857.07","0.42","EURd","SWAP","PROCESSED","2023-11-14 22:20:26","","Oil - Crude","Crude Oil","",""
"45147924490849","12856.65","0.42","EURd","SWAP","PROCESSED","2023-11-14 22:20:26","","Oil - Crude","Crude Oil","",""
"45139138464328","12856.23","29.59","EURd","TRADE","PROCESSED","2023-11-14 20:00:47","00081081-0055-311e-0000-4cdb00156775_00081081-0055-311e-0000-0000802505fa","BABA","Alibaba Group Holding Limited (Extended Hours)","",""
"45139132172851","12826.64","27.02","EURd","TRADE","PROCESSED","2023-11-14 20:00:41","00081081-0055-311e-0000-4cdb001565c7_00081081-0055-311e-0000-0000802506e1","BABA","Alibaba Group Holding Limited (Extended Hours)","",""
"45139127978524","12799.62","24.21","EURd","TRADE","PROCESSED","2023-11-14 20:00:37","00513301-0055-311e-0000-4cdb000e6401_00513301-0055-311e-0000-0000808b83d8","TSLA","Tesla Inc (Extended Hours)","",""
"45139124832786","12775.41","49.95","EURd","TRADE","PROCESSED","2023-11-14 20:00:34","00513301-0055-311e-0000-4cdb000e63ce_00513301-0055-311e-0000-0000808adc01","TSLA","Tesla Inc (Extended Hours)","",""
"45057374714417","12725.46","-0.41","EURd","SWAP","PROCESSED","2023-11-13 22:21:11","","BABA","Alibaba Group Holding Limited (Extended Hours)","",""
"45057374714370","12725.87","-0.41","EURd","SWAP","PROCESSED","2023-11-13 22:21:11","","BABA","Alibaba Group Holding Limited (Extended Hours)","",""
"45057368414478","12726.28","-0.28","EURd","SWAP","PROCESSED","2023-11-13 22:21:05","","TSLA","Tesla Inc (Extended Hours)","",""
"45057367364085","12726.56","-0.11","EURd","SWAP","PROCESSED","2023-11-13 22:21:04","","TSLA","Tesla Inc (Extended Hours)","",""
"45057367363955","12726.67","-0.17","EURd","SWAP","PROCESSED","2023-11-13 22:21:04","","TSLA","Tesla Inc (Extended Hours)","",""
"45057367363840","12726.84","-0.17","EURd","SWAP","PROCESSED","2023-11-13 22:21:04","","TSLA","Tesla Inc (Extended Hours)","",""
"45057325427694","12727.01","-0.29","EURd","SWAP","PROCESSED","2023-11-13 22:20:24","","VIX","Volatility Index","",""
"45057324378805","12727.3","-0.29","EURd","SWAP","PROCESSED","2023-11-13 22:20:23","","VIX","Volatility Index","",""
"45057324378675","12727.59","-0.29","EURd","SWAP","PROCESSED","2023-11-13 22:20:23","","VIX","Volatility Index","",""
"45057324378424","12727.88","-0.29","EURd","SWAP","PROCESSED","2023-11-13 22:20:23","","VIX","Volatility Index","",""
"44966780892255","12728.17","-0.41","EURd","SWAP","PROCESSED","2023-11-12 22:21:14","","BABA","Alibaba Group Holding Limited (Extended Hours)","",""
"44966780892194","12728.58","-0.41","EURd","SWAP","PROCESSED","2023-11-12 22:21:14","","BABA","Alibaba Group Holding Limited (Extended Hours)","",""
"44966766208088","12728.99","-0.26","EURd","SWAP","PROCESSED","2023-11-12 22:21:00","","TSLA","Tesla Inc (Extended Hours)","",""
"44966765157664","12729.25","-0.11","EURd","SWAP","PROCESSED","2023-11-12 22:20:59","","TSLA","Tesla Inc (Extended Hours)","",""
"44966765157548","12729.36","-0.16","EURd","SWAP","PROCESSED","2023-11-12 22:20:59","","TSLA","Tesla Inc (Extended Hours)","",""
"44966765157403","12729.52","-0.16","EURd","SWAP","PROCESSED","2023-11-12 22:20:59","","TSLA","Tesla Inc (Extended Hours)","",""
"44966759907616","12729.68","-0.29","EURd","SWAP","PROCESSED","2023-11-12 22:20:54","","VIX","Volatility Index","",""
"44966759907500","12729.97","-0.29","EURd","SWAP","PROCESSED","2023-11-12 22:20:54","","VIX","Volatility Index","",""
"44966759923531","12730.26","-0.29","EURd","SWAP","PROCESSED","2023-11-12 22:20:54","","VIX","Volatility Index","",""
"44876227967894","12730.55","-0.41","EURd","SWAP","PROCESSED","2023-11-11 22:21:56","","BABA","Alibaba Group Holding Limited (Extended Hours)","",""
"44876227967867","12730.96","-0.41","EURd","SWAP","PROCESSED","2023-11-11 22:21:56","","BABA","Alibaba Group Holding Limited (Extended Hours)","",""
"44876189167281","12731.37","-0.26","EURd","SWAP","PROCESSED","2023-11-11 22:21:19","","TSLA","Tesla Inc (Extended Hours)","",""
"44876187067793","12731.63","-0.11","EURd","SWAP","PROCESSED","2023-11-11 22:21:17","","TSLA","Tesla Inc (Extended Hours)","",""
"44876187067703","12731.74","-0.16","EURd","SWAP","PROCESSED","2023-11-11 22:21:17","","TSLA","Tesla Inc (Extended Hours)","",""
"44876187067550","12731.9","-0.16","EURd","SWAP","PROCESSED","2023-11-11 22:21:17","","TSLA","Tesla Inc (Extended Hours)","",""
"44876181817107","12732.06","-0.29","EURd","SWAP","PROCESSED","2023-11-11 22:21:12","","VIX","Volatility Index","",""
"44876181816984","12732.35","-0.29","EURd","SWAP","PROCESSED","2023-11-11 22:21:12","","VIX","Volatility Index","",""
"44876181816668","12732.64","-0.29","EURd","SWAP","PROCESSED","2023-11-11 22:21:12","","VIX","Volatility Index","",""
"44785530333952","12732.93","-0.41","EURd","SWAP","PROCESSED","2023-11-10 22:20:20","","BABA","Alibaba Group Holding Limited (Extended Hours)","",""
"44785530333889","12733.34","-0.41","EURd","SWAP","PROCESSED","2023-11-10 22:20:20","","BABA","Alibaba Group Holding Limited (Extended Hours)","",""
"44785524033659","12733.75","-0.26","EURd","SWAP","PROCESSED","2023-11-10 22:20:14","","TSLA","Tesla Inc (Extended Hours)","",""
"44785522998792","12734.01","-0.11","EURd","SWAP","PROCESSED","2023-11-10 22:20:13","","TSLA","Tesla Inc (Extended Hours)","",""
"44785522998665","12734.12","-0.16","EURd","SWAP","PROCESSED","2023-11-10 22:20:13","","TSLA","Tesla Inc (Extended Hours)","",""
"44785522998548","12734.28","-0.16","EURd","SWAP","PROCESSED","2023-11-10 22:20:13","","TSLA","Tesla Inc (Extended Hours)","",""
"44785511450091","12734.44","-0.29","EURd","SWAP","PROCESSED","2023-11-10 22:20:02","","VIX","Volatility Index","",""
"44785511449933","12734.73","-0.29","EURd","SWAP","PROCESSED","2023-11-10 22:20:02","","VIX","Volatility Index","",""
"44785511449647","12735.02","-0.29","EURd","SWAP","PROCESSED","2023-11-10 22:20:02","","VIX","Volatility Index","",""
"44769385400916","12735.31","14.75","EURd","TRADE","PROCESSED","2023-11-10 18:03:43","00513301-0055-311e-0000-4cd7000bb8f6_00513301-0055-311e-0000-0000808b3da5","TSLA","Tesla Inc (Extended Hours)","",""
"44756387263658","12720.56","-29.08","EURd","TRADE","PROCESSED","2023-11-10 14:37:07","00396101-0055-311e-0000-4cd7000294fa_00396101-0055-311e-0000-000080260f78","NVDA","NVIDIA Corp (Extended Hours)","",""
"44756387263656","12749.64","9.26","EURd","TRADE","PROCESSED","2023-11-10 14:37:07","00396101-0055-311e-0000-4cd7000294f9_00396101-0055-311e-0000-00008026b315","NVDA","NVIDIA Corp (Extended Hours)","",""
"44756384117891","12740.38","2.95","EURd","TRADE","PROCESSED","2023-11-10 14:37:04","00396101-0055-311e-0000-4cd70002930d_00396101-0055-311e-0000-0000802751d5","NVDA","NVIDIA Corp (Extended Hours)","",""
"44756243607321","12737.43","-4.96","EURd","TRADE","PROCESSED","2023-11-10 14:34:50","000144cd-0055-311e-0000-4cd700098370_000144cd-0055-311e-0000-0000804b003f","TSM","Taiwan Semiconductor Manufacturing Co Ltd - ADR (Extended Hours)","",""
"44756243607320","12742.39","27.62","EURd","TRADE","PROCESSED","2023-11-10 14:34:50","000144cd-0055-311e-0000-4cd70009836f_000144cd-0055-311e-0000-0000804d0017","TSM","Taiwan Semiconductor Manufacturing Co Ltd - ADR (Extended Hours)","",""
"44695035071780","12714.77","-0.31","EURd","SWAP","PROCESSED","2023-11-09 22:21:57","","VIX","Volatility Index","",""
"44695035071708","12715.08","-0.31","EURd","SWAP","PROCESSED","2023-11-09 22:21:57","","VIX","Volatility Index","",""
"44695035071540","12715.39","-0.31","EURd","SWAP","PROCESSED","2023-11-09 22:21:57","","VIX","Volatility Index","",""
"44695032973081","12715.7","-0.22","EURd","SWAP","PROCESSED","2023-11-09 22:21:55","","TSM","Taiwan Semiconductor Manufacturing Co Ltd - ADR (Extended Hours)","",""
"44695032973038","12715.92","-0.22","EURd","SWAP","PROCESSED","2023-11-09 22:21:55","","TSM","Taiwan Semiconductor Manufacturing Co Ltd - ADR (Extended Hours)","",""
"44695029840356","12716.14","-0.26","EURd","SWAP","PROCESSED","2023-11-09 22:21:52","","TSLA","Tesla Inc (Extended Hours)","",""
"44695028790050","12716.4","-0.1","EURd","SWAP","PROCESSED","2023-11-09 22:21:51","","TSLA","Tesla Inc (Extended Hours)","",""
"44695028789976","12716.5","-0.16","EURd","SWAP","PROCESSED","2023-11-09 22:21:51","","TSLA","Tesla Inc (Extended Hours)","",""
"44695028789878","12716.66","-0.16","EURd","SWAP","PROCESSED","2023-11-09 22:21:51","","TSLA","Tesla Inc (Extended Hours)","",""
"44695016208477","12716.82","-0.12","EURd","SWAP","PROCESSED","2023-11-09 22:21:39","","NVDA","NVIDIA Corp (Extended Hours)","",""
"44695016208000","12716.94","-0.35","EURd","SWAP","PROCESSED","2023-11-09 22:21:39","","NVDA","NVIDIA Corp (Extended Hours)","",""
"44694980554676","12717.29","-0.41","EURd","SWAP","PROCESSED","2023-11-09 22:21:05","","BABA","Alibaba Group Holding Limited (Extended Hours)","",""
"44604436008431","12717.7","-0.12","EURd","SWAP","PROCESSED","2023-11-08 22:21:55","","NVDA","NVIDIA Corp (Extended Hours)","",""
"44604436008079","12717.82","-0.35","EURd","SWAP","PROCESSED","2023-11-08 22:21:55","","NVDA","NVIDIA Corp (Extended Hours)","",""
"44604387771802","12718.17","-0.27","EURd","SWAP","PROCESSED","2023-11-08 22:21:09","","TSLA","Tesla Inc (Extended Hours)","",""
"44604385688117","12718.44","-0.11","EURd","SWAP","PROCESSED","2023-11-08 22:21:07","","TSLA","Tesla Inc (Extended Hours)","",""
"44604385687940","12718.55","-0.17","EURd","SWAP","PROCESSED","2023-11-08 22:21:07","","TSLA","Tesla Inc (Extended Hours)","",""
"44604385687812","12718.72","-0.17","EURd","SWAP","PROCESSED","2023-11-08 22:21:07","","TSLA","Tesla Inc (Extended Hours)","",""
"44604367852106","12718.89","-0.42","EURd","SWAP","PROCESSED","2023-11-08 22:20:50","","BABA","Alibaba Group Holding Limited (Extended Hours)","",""
"44604318564659","12719.31","-0.23","EURd","SWAP","PROCESSED","2023-11-08 22:20:03","","TSM","Taiwan Semiconductor Manufacturing Co Ltd - ADR (Extended Hours)","",""
"44604318564596","12719.54","-0.23","EURd","SWAP","PROCESSED","2023-11-08 22:20:03","","TSM","Taiwan Semiconductor Manufacturing Co Ltd - ADR (Extended Hours)","",""
"44604317531436","12719.77","-0.3","EURd","SWAP","PROCESSED","2023-11-08 22:20:02","","VIX","Volatility Index","",""
"44604317531248","12720.07","-0.3","EURd","SWAP","PROCESSED","2023-11-08 22:20:02","","VIX","Volatility Index","",""
"44604317530889","12720.37","-0.3","EURd","SWAP","PROCESSED","2023-11-08 22:20:02","","VIX","Volatility Index","",""
"44513822275734","12720.67","-0.28","EURd","SWAP","PROCESSED","2023-11-07 22:21:39","","TSLA","Tesla Inc (Extended Hours)","",""
"44513821224467","12720.95","-0.11","EURd","SWAP","PROCESSED","2023-11-07 22:21:38","","TSLA","Tesla Inc (Extended Hours)","",""
"44513821224357","12721.06","-0.17","EURd","SWAP","PROCESSED","2023-11-07 22:21:38","","TSLA","Tesla Inc (Extended Hours)","",""
"44513821224251","12721.23","-0.17","EURd","SWAP","PROCESSED","2023-11-07 22:21:38","","TSLA","Tesla Inc (Extended Hours)","",""
"44513792902175","12721.4","-0.12","EURd","SWAP","PROCESSED","2023-11-07 22:21:11","","NVDA","NVIDIA Corp (Extended Hours)","",""
"44513792901531","12721.52","-0.35","EURd","SWAP","PROCESSED","2023-11-07 22:21:11","","NVDA","NVIDIA Corp (Extended Hours)","",""
"44513778231232","12721.87","-0.3","EURd","SWAP","PROCESSED","2023-11-07 22:20:57","","VIX","Volatility Index","",""
"44513777182358","12722.17","-0.3","EURd","SWAP","PROCESSED","2023-11-07 22:20:56","","VIX","Volatility Index","",""
"44513765645766","12722.47","-0.42","EURd","SWAP","PROCESSED","2023-11-07 22:20:45","","BABA","Alibaba Group Holding Limited (Extended Hours)","",""
"44513721605970","12722.89","-0.23","EURd","SWAP","PROCESSED","2023-11-07 22:20:03","","TSM","Taiwan Semiconductor Manufacturing Co Ltd - ADR (Extended Hours)","",""
"44513721605909","12723.12","-0.23","EURd","SWAP","PROCESSED","2023-11-07 22:20:03","","TSM","Taiwan Semiconductor Manufacturing Co Ltd - ADR (Extended Hours)","",""
"44423137228942","12723.35","-0.3","EURd","SWAP","PROCESSED","2023-11-06 22:20:15","","VIX","Volatility Index","",""
"44423135129890","12723.65","-0.3","EURd","SWAP","PROCESSED","2023-11-06 22:20:13","","VIX","Volatility Index","",""
"44420160309748","12723.95","6.2","EURd","TRADE","PROCESSED","2023-11-06 21:32:56","00396101-0055-311e-0000-4cd3001717b8_00396101-0055-311e-0000-000080273487","NVDA","NVIDIA Corp (Extended Hours)","",""
"44419405344606","12717.75","-0.56","EURd","SWAP","PROCESSED","2023-11-06 21:20:56","","NVDA","NVIDIA Corp (Extended Hours)","",""
"44419404294910","12718.31","-0.11","EURd","SWAP","PROCESSED","2023-11-06 21:20:55","","NVDA","NVIDIA Corp (Extended Hours)","",""
"44419404294165","12718.42","-0.34","EURd","SWAP","PROCESSED","2023-11-06 21:20:55","","NVDA","NVIDIA Corp (Extended Hours)","",""
"44419382274280","12718.76","-0.23","EURd","SWAP","PROCESSED","2023-11-06 21:20:34","","TSM","Taiwan Semiconductor Manufacturing Co Ltd - ADR (Extended Hours)","",""
"44419382274205","12718.99","-0.23","EURd","SWAP","PROCESSED","2023-11-06 21:20:34","","TSM","Taiwan Semiconductor Manufacturing Co Ltd - ADR (Extended Hours)","",""
"44419364438403","12719.22","-0.27","EURd","SWAP","PROCESSED","2023-11-06 21:20:17","","TSLA","Tesla Inc (Extended Hours)","",""
"44419362354331","12719.49","-0.11","EURd","SWAP","PROCESSED","2023-11-06 21:20:15","","TSLA","Tesla Inc (Extended Hours)","",""
"44419362354136","12719.6","-0.17","EURd","SWAP","PROCESSED","2023-11-06 21:20:15","","TSLA","Tesla Inc (Extended Hours)","",""
"44419362354026","12719.77","-0.17","EURd","SWAP","PROCESSED","2023-11-06 21:20:15","","TSLA","Tesla Inc (Extended Hours)","",""
"44328853463799","12719.94","-0.31","EURd","SWAP","PROCESSED","2023-11-05 21:21:39","","VIX","Volatility Index","",""
"44328852414981","12720.25","-0.31","EURd","SWAP","PROCESSED","2023-11-05 21:21:38","","VIX","Volatility Index","",""
"44328848214213","12720.56","-0.11","EURd","SWAP","PROCESSED","2023-11-05 21:21:34","","NVDA","NVIDIA Corp (Extended Hours)","",""
"44328847164136","12720.67","-0.34","EURd","SWAP","PROCESSED","2023-11-05 21:21:33","","NVDA","NVIDIA Corp (Extended Hours)","",""
"44328788447755","12721.01","-0.23","EURd","SWAP","PROCESSED","2023-11-05 21:20:37","","TSM","Taiwan Semiconductor Manufacturing Co Ltd - ADR (Extended Hours)","",""
"44328788447697","12721.24","-0.23","EURd","SWAP","PROCESSED","2023-11-05 21:20:37","","TSM","Taiwan Semiconductor Manufacturing Co Ltd - ADR (Extended Hours)","",""
"44328776910931","12721.47","-0.11","EURd","SWAP","PROCESSED","2023-11-05 21:20:26","","TSLA","Tesla Inc (Extended Hours)","",""
"44328776910749","12721.58","-0.17","EURd","SWAP","PROCESSED","2023-11-05 21:20:26","","TSLA","Tesla Inc (Extended Hours)","",""
"44328776910622","12721.75","-0.17","EURd","SWAP","PROCESSED","2023-11-05 21:20:26","","TSLA","Tesla Inc (Extended Hours)","",""
"44238263837486","12721.92","-0.23","EURd","SWAP","PROCESSED","2023-11-04 21:21:46","","TSM","Taiwan Semiconductor Manufacturing Co Ltd - ADR (Extended Hours)","",""
"44238263837459","12722.15","-0.23","EURd","SWAP","PROCESSED","2023-11-04 21:21:46","","TSM","Taiwan Semiconductor Manufacturing Co Ltd - ADR (Extended Hours)","",""
"44238252305261","12722.38","-0.11","EURd","SWAP","PROCESSED","2023-11-04 21:21:35","","TSLA","Tesla Inc (Extended Hours)","",""
"44238251256503","12722.49","-0.17","EURd","SWAP","PROCESSED","2023-11-04 21:21:34","","TSLA","Tesla Inc (Extended Hours)","",""
"44238251256380","12722.66","-0.17","EURd","SWAP","PROCESSED","2023-11-04 21:21:34","","TSLA","Tesla Inc (Extended Hours)","",""
"44238172616115","12722.83","-0.11","EURd","SWAP","PROCESSED","2023-11-04 21:20:19","","NVDA","NVIDIA Corp (Extended Hours)","",""
"44238172615437","12722.94","-0.34","EURd","SWAP","PROCESSED","2023-11-04 21:20:19","","NVDA","NVIDIA Corp (Extended Hours)","",""
"44238171565252","12723.28","-0.31","EURd","SWAP","PROCESSED","2023-11-04 21:20:18","","VIX","Volatility Index","",""
"44238171564931","12723.59","-0.31","EURd","SWAP","PROCESSED","2023-11-04 21:20:18","","VIX","Volatility Index","",""
"44199559852831","12723.9","3.54","EURd","TRADE","PROCESSED","2023-11-04 11:06:35","0015421d-0055-311e-0000-4cd100034075_0015421d-0055-311e-0000-000080e76b2c","ETH/USD","Ethereum / USD","",""
"44199559852830","12720.36","20.41","EURd","TRADE","PROCESSED","2023-11-04 11:06:35","0015421d-0055-311e-0000-4cd100034074_0015421d-0055-311e-0000-000080e774ef","ETH/USD","Ethereum / USD","",""
"44147769626102","12699.95","-0.11","EURd","SWAP","PROCESSED","2023-11-03 21:23:24","","NVDA","NVIDIA Corp (Extended Hours)","",""
"44147769625583","12700.06","-0.34","EURd","SWAP","PROCESSED","2023-11-03 21:23:24","","NVDA","NVIDIA Corp (Extended Hours)","",""
"44147731881705","12700.4","-0.31","EURd","SWAP","PROCESSED","2023-11-03 21:22:48","","VIX","Volatility Index","",""
"44147731881374","12700.71","-0.31","EURd","SWAP","PROCESSED","2023-11-03 21:22:48","","VIX","Volatility Index","",""
"44147655341958","12701.02","-0.11","EURd","SWAP","PROCESSED","2023-11-03 21:21:35","","TSLA","Tesla Inc (Extended Hours)","",""
"44147655341775","12701.13","-0.17","EURd","SWAP","PROCESSED","2023-11-03 21:21:35","","TSLA","Tesla Inc (Extended Hours)","",""
"44147655341649","12701.3","-0.17","EURd","SWAP","PROCESSED","2023-11-03 21:21:35","","TSLA","Tesla Inc (Extended Hours)","",""
"44147617580746","12701.47","-0.53","EURd","SWAP","PROCESSED","2023-11-03 21:20:59","","ETH/USD","Ethereum / USD","",""
"44147616531808","12702","-0.53","EURd","SWAP","PROCESSED","2023-11-03 21:20:58","","ETH/USD","Ethereum / USD","",""
"44147591379434","12702.53","-0.23","EURd","SWAP","PROCESSED","2023-11-03 21:20:34","","TSM","Taiwan Semiconductor Manufacturing Co Ltd - ADR (Extended Hours)","",""
"44147591379371","12702.76","-0.23","EURd","SWAP","PROCESSED","2023-11-03 21:20:34","","TSM","Taiwan Semiconductor Manufacturing Co Ltd - ADR (Extended Hours)","",""
"44117000210501","12702.99","24.63","EURd","TRADE","PROCESSED","2023-11-03 13:14:20","00513301-0055-311e-0000-4cd000070aed_00513301-0055-311e-0000-0000808a056a","TSLA","Tesla Inc (Extended Hours)","",""
"44116997064752","12678.36","52.25","EURd","TRADE","PROCESSED","2023-11-03 13:14:17","00513301-0055-311e-0000-4cd000070abc_00513301-0055-311e-0000-0000808aa5b1","TSLA","Tesla Inc (Extended Hours)","",""
"44116986578910","12626.11","15.12","EURd","TRADE","PROCESSED","2023-11-03 13:14:07","00396101-0055-311e-0000-4cd000019860_00396101-0055-311e-0000-000080270594","NVDA","NVIDIA Corp (Extended Hours)","",""
"44116983433165","12610.99","10","EURd","TRADE","PROCESSED","2023-11-03 13:14:04","00082581-0015-549e-0000-4cd000067269_00082581-0015-549e-0000-000080270049","BBVA","BBVA","",""
"44057213563978","12600.99","-0.23","EURd","SWAP","PROCESSED","2023-11-02 21:24:03","","TSM","Taiwan Semiconductor Manufacturing Co Ltd - ADR (Extended Hours)","",""
"44057213563954","12601.22","-0.23","EURd","SWAP","PROCESSED","2023-11-02 21:24:03","","TSM","Taiwan Semiconductor Manufacturing Co Ltd - ADR (Extended Hours)","",""
"44057189434892","12601.45","-0.32","EURd","SWAP","PROCESSED","2023-11-02 21:23:40","","VIX","Volatility Index","",""
"44057147497132","12601.77","-0.33","EURd","SWAP","PROCESSED","2023-11-02 21:23:00","","BBVA","BBVA","",""
"44057065712227","12602.1","-0.33","EURd","SWAP","PROCESSED","2023-11-02 21:21:42","","NVDA","NVIDIA Corp (Extended Hours)","",""
"44057064663256","12602.43","-0.11","EURd","SWAP","PROCESSED","2023-11-02 21:21:41","","NVDA","NVIDIA Corp (Extended Hours)","",""
"44057063614006","12602.54","-0.33","EURd","SWAP","PROCESSED","2023-11-02 21:21:40","","NVDA","NVIDIA Corp (Extended Hours)","",""
"44057054169601","12602.87","-0.53","EURd","SWAP","PROCESSED","2023-11-02 21:21:31","","ETH/USD","Ethereum / USD","",""
"44056978685794","12603.4","-0.27","EURd","SWAP","PROCESSED","2023-11-02 21:20:19","","TSLA","Tesla Inc (Extended Hours)","",""
"44056975537945","12603.67","-0.27","EURd","SWAP","PROCESSED","2023-11-02 21:20:16","","TSLA","Tesla Inc (Extended Hours)","",""
"44056973439438","12603.94","-0.11","EURd","SWAP","PROCESSED","2023-11-02 21:20:14","","TSLA","Tesla Inc (Extended Hours)","",""
"44056973439176","12604.05","-0.17","EURd","SWAP","PROCESSED","2023-11-02 21:20:14","","TSLA","Tesla Inc (Extended Hours)","",""
"44056972390407","12604.22","-0.17","EURd","SWAP","PROCESSED","2023-11-02 21:20:13","","TSLA","Tesla Inc (Extended Hours)","",""
"44012649071127","12604.39","28.44","EURd","TRADE","PROCESSED","2023-11-02 09:35:43","000144cd-0055-311e-0000-4ccf0004dc14_000144cd-0055-311e-0000-0000804d0037","TSM","Taiwan Semiconductor Manufacturing Co Ltd - ADR (Extended Hours)","",""
"44012646973957","12575.95","6.78","EURd","TRADE","PROCESSED","2023-11-02 09:35:41","00081081-0055-311e-0000-4ccf0000f712_00081081-0055-311e-0000-00008025030f","BABA","Alibaba Group Holding Limited (Extended Hours)","",""
"43966498101255","12569.17","-0.32","EURd","SWAP","PROCESSED","2023-11-01 21:22:10","","NVDA","NVIDIA Corp (Extended Hours)","",""
"43966497052220","12569.49","-0.11","EURd","SWAP","PROCESSED","2023-11-01 21:22:09","","NVDA","NVIDIA Corp (Extended Hours)","",""
"43966496003021","12569.6","-0.32","EURd","SWAP","PROCESSED","2023-11-01 21:22:08","","NVDA","NVIDIA Corp (Extended Hours)","",""
"43966490756843","12569.92","-0.22","EURd","SWAP","PROCESSED","2023-11-01 21:22:03","","TSM","Taiwan Semiconductor Manufacturing Co Ltd - ADR (Extended Hours)","",""
"43966490756825","12570.14","-0.22","EURd","SWAP","PROCESSED","2023-11-01 21:22:03","","TSM","Taiwan Semiconductor Manufacturing Co Ltd - ADR (Extended Hours)","",""
"43966490756797","12570.36","-0.22","EURd","SWAP","PROCESSED","2023-11-01 21:22:03","","TSM","Taiwan Semiconductor Manufacturing Co Ltd - ADR (Extended Hours)","",""
"43966402684623","12570.58","-0.26","EURd","SWAP","PROCESSED","2023-11-01 21:20:39","","TSLA","Tesla Inc (Extended Hours)","",""
"43966400586186","12570.84","-0.1","EURd","SWAP","PROCESSED","2023-11-01 21:20:37","","TSLA","Tesla Inc (Extended Hours)","",""
"43966400586031","12570.94","-0.16","EURd","SWAP","PROCESSED","2023-11-01 21:20:37","","TSLA","Tesla Inc (Extended Hours)","",""
"43966400585906","12571.1","-0.16","EURd","SWAP","PROCESSED","2023-11-01 21:20:37","","TSLA","Tesla Inc (Extended Hours)","",""
"43965861621605","12571.26","-34.35","EURd","TRADE","PROCESSED","2023-11-01 21:12:03","00001344-0055-311e-0000-4cce001ee464_00001344-0055-311e-0000-000080220cb4","AMD","Advanced Micro Devices Inc (Extended Hours)","",""
"43965861621565","12605.61","-8.59","EURd","TRADE","PROCESSED","2023-11-01 21:12:03","00001344-0055-311e-0000-4cce001ee463_00001344-0055-311e-0000-000080220cb2","AMD","Advanced Micro Devices Inc (Extended Hours)","",""
"43965809193190","12614.2","65.83","EURd","TRADE","PROCESSED","2023-11-01 21:11:13","00001344-0055-311e-0000-4cce001ee409_00001344-0055-311e-0000-000080250182","AMD","Advanced Micro Devices Inc (Extended Hours)","",""
"43965090910634","12548.37","50.38","EURd","TRADE","PROCESSED","2023-11-01 20:59:48","00513301-0055-311e-0000-4cce000f5d99_00513301-0055-311e-0000-0000808a6fa3","TSLA","Tesla Inc (Extended Hours)","",""
"43876019629377","12497.99","-0.25","EURd","SWAP","PROCESSED","2023-10-31 21:24:03","","AMD","Advanced Micro Devices Inc (Extended Hours)","",""
"43876018580390","12498.24","-0.2","EURd","SWAP","PROCESSED","2023-10-31 21:24:02","","AMD","Advanced Micro Devices Inc (Extended Hours)","",""
"43876018580364","12498.44","-0.06","EURd","SWAP","PROCESSED","2023-10-31 21:24:02","","AMD","Advanced Micro Devices Inc (Extended Hours)","",""
"43875923148952","12498.5","-0.22","EURd","SWAP","PROCESSED","2023-10-31 21:22:31","","TSM","Taiwan Semiconductor Manufacturing Co Ltd - ADR (Extended Hours)","",""
"43875923148890","12498.72","-0.22","EURd","SWAP","PROCESSED","2023-10-31 21:22:31","","TSM","Taiwan Semiconductor Manufacturing Co Ltd - ADR (Extended Hours)","",""
"43875923148839","12498.94","-0.22","EURd","SWAP","PROCESSED","2023-10-31 21:22:31","","TSM","Taiwan Semiconductor Manufacturing Co Ltd - ADR (Extended Hours)","",""
"43875861292389","12499.16","-0.26","EURd","SWAP","PROCESSED","2023-10-31 21:21:32","","TSLA","Tesla Inc (Extended Hours)","",""
"43875858144812","12499.42","-0.26","EURd","SWAP","PROCESSED","2023-10-31 21:21:29","","TSLA","Tesla Inc (Extended Hours)","",""
"43875856046444","12499.68","-0.1","EURd","SWAP","PROCESSED","2023-10-31 21:21:27","","TSLA","Tesla Inc (Extended Hours)","",""
"43875856046051","12499.78","-0.15","EURd","SWAP","PROCESSED","2023-10-31 21:21:27","","TSLA","Tesla Inc (Extended Hours)","",""
"43875854997322","12499.93","-0.15","EURd","SWAP","PROCESSED","2023-10-31 21:21:26","","TSLA","Tesla Inc (Extended Hours)","",""
"43875810962652","12500.08","-0.3","EURd","SWAP","PROCESSED","2023-10-31 21:20:44","","NVDA","NVIDIA Corp (Extended Hours)","",""
"43875810962150","12500.38","-0.1","EURd","SWAP","PROCESSED","2023-10-31 21:20:44","","NVDA","NVIDIA Corp (Extended Hours)","",""
"43875807814745","12500.48","-0.3","EURd","SWAP","PROCESSED","2023-10-31 21:20:41","","NVDA","NVIDIA Corp (Extended Hours)","",""
"43785367087416","12500.78","-0.31","EURd","SWAP","PROCESSED","2023-10-30 21:23:10","","NVDA","NVIDIA Corp (Extended Hours)","",""
"43785366038322","12501.09","-0.1","EURd","SWAP","PROCESSED","2023-10-30 21:23:09","","NVDA","NVIDIA Corp (Extended Hours)","",""
"43785364989120","12501.19","-0.31","EURd","SWAP","PROCESSED","2023-10-30 21:23:08","","NVDA","NVIDIA Corp (Extended Hours)","",""
"43785350314038","12501.5","-0.24","EURd","SWAP","PROCESSED","2023-10-30 21:22:54","","TSLA","Tesla Inc (Extended Hours)","",""
"43785347166159","12501.74","-0.24","EURd","SWAP","PROCESSED","2023-10-30 21:22:51","","TSLA","Tesla Inc (Extended Hours)","",""
"43785345067692","12501.98","-0.1","EURd","SWAP","PROCESSED","2023-10-30 21:22:49","","TSLA","Tesla Inc (Extended Hours)","",""
"43785345067280","12502.08","-0.15","EURd","SWAP","PROCESSED","2023-10-30 21:22:49","","TSLA","Tesla Inc (Extended Hours)","",""
"43785345067109","12502.23","-0.15","EURd","SWAP","PROCESSED","2023-10-30 21:22:49","","TSLA","Tesla Inc (Extended Hours)","",""
"43785335623864","12502.38","-0.24","EURd","SWAP","PROCESSED","2023-10-30 21:22:40","","AMD","Advanced Micro Devices Inc (Extended Hours)","",""
"43785334574652","12502.62","-0.2","EURd","SWAP","PROCESSED","2023-10-30 21:22:39","","AMD","Advanced Micro Devices Inc (Extended Hours)","",""
"43785334574595","12502.82","-0.06","EURd","SWAP","PROCESSED","2023-10-30 21:22:39","","AMD","Advanced Micro Devices Inc (Extended Hours)","",""
"43785167863502","12502.88","-0.22","EURd","SWAP","PROCESSED","2023-10-30 21:20:00","","TSM","Taiwan Semiconductor Manufacturing Co Ltd - ADR (Extended Hours)","",""
"43785167863465","12503.1","-0.22","EURd","SWAP","PROCESSED","2023-10-30 21:20:00","","TSM","Taiwan Semiconductor Manufacturing Co Ltd - ADR (Extended Hours)","",""
"43785167863416","12503.32","-0.22","EURd","SWAP","PROCESSED","2023-10-30 21:20:00","","TSM","Taiwan Semiconductor Manufacturing Co Ltd - ADR (Extended Hours)","",""
"43694780600587","12503.54","-0.22","EURd","SWAP","PROCESSED","2023-10-29 21:23:20","","TSM","Taiwan Semiconductor Manufacturing Co Ltd - ADR (Extended Hours)","",""
"43694780600530","12503.76","-0.22","EURd","SWAP","PROCESSED","2023-10-29 21:23:20","","TSM","Taiwan Semiconductor Manufacturing Co Ltd - ADR (Extended Hours)","",""
"43694780600473","12503.98","-0.22","EURd","SWAP","PROCESSED","2023-10-29 21:23:20","","TSM","Taiwan Semiconductor Manufacturing Co Ltd - ADR (Extended Hours)","",""
"43694673647753","12504.2","-0.25","EURd","SWAP","PROCESSED","2023-10-29 21:21:38","","AMD","Advanced Micro Devices Inc (Extended Hours)","",""
"43694672598660","12504.45","-0.2","EURd","SWAP","PROCESSED","2023-10-29 21:21:37","","AMD","Advanced Micro Devices Inc (Extended Hours)","",""
"43694672598578","12504.65","-0.06","EURd","SWAP","PROCESSED","2023-10-29 21:21:37","","AMD","Advanced Micro Devices Inc (Extended Hours)","",""
"43694641136186","12504.71","-0.26","EURd","SWAP","PROCESSED","2023-10-29 21:21:07","","TSLA","Tesla Inc (Extended Hours)","",""
"43694638005282","12504.97","-0.1","EURd","SWAP","PROCESSED","2023-10-29 21:21:04","","TSLA","Tesla Inc (Extended Hours)","",""
"43694638004880","12505.07","-0.16","EURd","SWAP","PROCESSED","2023-10-29 21:21:04","","TSLA","Tesla Inc (Extended Hours)","",""
"43694638004696","12505.23","-0.16","EURd","SWAP","PROCESSED","2023-10-29 21:21:04","","TSLA","Tesla Inc (Extended Hours)","",""
"43694579276131","12505.39","-0.3","EURd","SWAP","PROCESSED","2023-10-29 21:20:08","","NVDA","NVIDIA Corp (Extended Hours)","",""
"43694578227069","12505.69","-0.1","EURd","SWAP","PROCESSED","2023-10-29 21:20:07","","NVDA","NVIDIA Corp (Extended Hours)","",""
"43694577177795","12505.79","-0.3","EURd","SWAP","PROCESSED","2023-10-29 21:20:06","","NVDA","NVIDIA Corp (Extended Hours)","",""
"43663123044099","12506.09","10.58","EURd","TRADE","PROCESSED","2023-10-29 13:00:09","0015421d-0055-311e-0000-4ccb0003bd02_0015421d-0055-311e-0000-000080e73cbe","ETH/USD","Ethereum / USD","",""
"43604187827937","12495.51","-0.22","EURd","SWAP","PROCESSED","2023-10-28 21:23:24","","TSM","Taiwan Semiconductor Manufacturing Co Ltd - ADR (Extended Hours)","",""
"43604187827902","12495.73","-0.22","EURd","SWAP","PROCESSED","2023-10-28 21:23:24","","TSM","Taiwan Semiconductor Manufacturing Co Ltd - ADR (Extended Hours)","",""
"43604187827836","12495.95","-0.22","EURd","SWAP","PROCESSED","2023-10-28 21:23:24","","TSM","Taiwan Semiconductor Manufacturing Co Ltd - ADR (Extended Hours)","",""
"43604143791439","12496.17","-0.3","EURd","SWAP","PROCESSED","2023-10-28 21:22:42","","NVDA","NVIDIA Corp (Extended Hours)","",""
"43604143791079","12496.47","-0.1","EURd","SWAP","PROCESSED","2023-10-28 21:22:42","","NVDA","NVIDIA Corp (Extended Hours)","",""
"43604142741813","12496.57","-0.3","EURd","SWAP","PROCESSED","2023-10-28 21:22:41","","NVDA","NVIDIA Corp (Extended Hours)","",""
"43604128068730","12496.87","-0.27","EURd","SWAP","PROCESSED","2023-10-28 21:22:27","","TSLA","Tesla Inc (Extended Hours)","",""
"43604125970310","12497.14","-0.1","EURd","SWAP","PROCESSED","2023-10-28 21:22:25","","TSLA","Tesla Inc (Extended Hours)","",""
"43604125969959","12497.24","-0.16","EURd","SWAP","PROCESSED","2023-10-28 21:22:25","","TSLA","Tesla Inc (Extended Hours)","",""
"43604124921201","12497.4","-0.16","EURd","SWAP","PROCESSED","2023-10-28 21:22:24","","TSLA","Tesla Inc (Extended Hours)","",""
"43604114427834","12497.56","-0.25","EURd","SWAP","PROCESSED","2023-10-28 21:22:14","","AMD","Advanced Micro Devices Inc (Extended Hours)","",""
"43604113378768","12497.81","-0.2","EURd","SWAP","PROCESSED","2023-10-28 21:22:13","","AMD","Advanced Micro Devices Inc (Extended Hours)","",""
"43604113378710","12498.01","-0.06","EURd","SWAP","PROCESSED","2023-10-28 21:22:13","","AMD","Advanced Micro Devices Inc (Extended Hours)","",""
"43604064096159","12498.07","-1.04","EURd","SWAP","PROCESSED","2023-10-28 21:21:26","","ETH/USD","Ethereum / USD","",""
"43513524804624","12499.11","-0.22","EURd","SWAP","PROCESSED","2023-10-27 21:22:21","","TSM","Taiwan Semiconductor Manufacturing Co Ltd - ADR (Extended Hours)","",""
"43513524804564","12499.33","-0.22","EURd","SWAP","PROCESSED","2023-10-27 21:22:21","","TSM","Taiwan Semiconductor Manufacturing Co Ltd - ADR (Extended Hours)","",""
"43513524804481","12499.55","-0.22","EURd","SWAP","PROCESSED","2023-10-27 21:22:21","","TSM","Taiwan Semiconductor Manufacturing Co Ltd - ADR (Extended Hours)","",""
"43513506982009","12499.77","-0.25","EURd","SWAP","PROCESSED","2023-10-27 21:22:04","","AMD","Advanced Micro Devices Inc (Extended Hours)","",""
"43513505932453","12500.02","-0.2","EURd","SWAP","PROCESSED","2023-10-27 21:22:03","","AMD","Advanced Micro Devices Inc (Extended Hours)","",""
"43513505932390","12500.22","-0.06","EURd","SWAP","PROCESSED","2023-10-27 21:22:03","","AMD","Advanced Micro Devices Inc (Extended Hours)","",""
"43513493340652","12500.28","-0.27","EURd","SWAP","PROCESSED","2023-10-27 21:21:51","","TSLA","Tesla Inc (Extended Hours)","",""
"43513491258533","12500.55","-0.1","EURd","SWAP","PROCESSED","2023-10-27 21:21:49","","TSLA","Tesla Inc (Extended Hours)","",""
"43513491258163","12500.65","-0.16","EURd","SWAP","PROCESSED","2023-10-27 21:21:49","","TSLA","Tesla Inc (Extended Hours)","",""
"43513490209423","12500.81","-0.16","EURd","SWAP","PROCESSED","2023-10-27 21:21:48","","TSLA","Tesla Inc (Extended Hours)","",""
"43513441972048","12500.97","-0.3","EURd","SWAP","PROCESSED","2023-10-27 21:21:02","","NVDA","NVIDIA Corp (Extended Hours)","",""
"43513440922973","12501.27","-0.1","EURd","SWAP","PROCESSED","2023-10-27 21:21:01","","NVDA","NVIDIA Corp (Extended Hours)","",""
"43513439873622","12501.37","-0.3","EURd","SWAP","PROCESSED","2023-10-27 21:21:00","","NVDA","NVIDIA Corp (Extended Hours)","",""
"43425125656873","12501.67","27.97","EURd","TRADE","PROCESSED","2023-10-26 21:57:17","0015421d-0055-311e-0000-4cc8000b2b73_0015421d-0055-311e-0000-000080e71dd9","ETH/USD","Ethereum / USD","",""
"43422998091427","12473.7","-0.22","EURd","SWAP","PROCESSED","2023-10-26 21:23:28","","TSM","Taiwan Semiconductor Manufacturing Co Ltd - ADR (Extended Hours)","",""
"43422998091368","12473.92","-0.22","EURd","SWAP","PROCESSED","2023-10-26 21:23:28","","TSM","Taiwan Semiconductor Manufacturing Co Ltd - ADR (Extended Hours)","",""
"43422938317262","12474.14","-1.58","EURd","SWAP","PROCESSED","2023-10-26 21:22:31","","ETH/USD","Ethereum / USD","",""
"43422857589970","12475.72","-0.3","EURd","SWAP","PROCESSED","2023-10-26 21:21:14","","NVDA","NVIDIA Corp (Extended Hours)","",""
"43422856540925","12476.02","-0.1","EURd","SWAP","PROCESSED","2023-10-26 21:21:13","","NVDA","NVIDIA Corp (Extended Hours)","",""
"43422855491479","12476.12","-0.3","EURd","SWAP","PROCESSED","2023-10-26 21:21:12","","NVDA","NVIDIA Corp (Extended Hours)","",""
"43422810405425","12476.42","-0.24","EURd","SWAP","PROCESSED","2023-10-26 21:20:29","","AMD","Advanced Micro Devices Inc (Extended Hours)","",""
"43422809356196","12476.66","-0.19","EURd","SWAP","PROCESSED","2023-10-26 21:20:28","","AMD","Advanced Micro Devices Inc (Extended Hours)","",""
"43422809356145","12476.85","-0.05","EURd","SWAP","PROCESSED","2023-10-26 21:20:28","","AMD","Advanced Micro Devices Inc (Extended Hours)","",""
"43422802011306","12476.9","-0.26","EURd","SWAP","PROCESSED","2023-10-26 21:20:21","","TSLA","Tesla Inc (Extended Hours)","",""
"43422799912760","12477.16","-0.1","EURd","SWAP","PROCESSED","2023-10-26 21:20:19","","TSLA","Tesla Inc (Extended Hours)","",""
"43422799912438","12477.26","-0.16","EURd","SWAP","PROCESSED","2023-10-26 21:20:19","","TSLA","Tesla Inc (Extended Hours)","",""
"43422799912346","12477.42","-0.16","EURd","SWAP","PROCESSED","2023-10-26 21:20:19","","TSLA","Tesla Inc (Extended Hours)","",""
"43332373869291","12477.58","-0.31","EURd","SWAP","PROCESSED","2023-10-25 21:23:02","","NVDA","NVIDIA Corp (Extended Hours)","",""
"43332372820234","12477.89","-0.1","EURd","SWAP","PROCESSED","2023-10-25 21:23:01","","NVDA","NVIDIA Corp (Extended Hours)","",""
"43332371770634","12477.99","-0.31","EURd","SWAP","PROCESSED","2023-10-25 21:23:00","","NVDA","NVIDIA Corp (Extended Hours)","",""
"43332352898731","12478.3","-0.26","EURd","SWAP","PROCESSED","2023-10-25 21:22:42","","TSLA","Tesla Inc (Extended Hours)","",""
"43332350799942","12478.56","-0.11","EURd","SWAP","PROCESSED","2023-10-25 21:22:40","","TSLA","Tesla Inc (Extended Hours)","",""
"43332350799598","12478.67","-0.16","EURd","SWAP","PROCESSED","2023-10-25 21:22:40","","TSLA","Tesla Inc (Extended Hours)","",""
"43332350799417","12478.83","-0.16","EURd","SWAP","PROCESSED","2023-10-25 21:22:40","","TSLA","Tesla Inc (Extended Hours)","",""
"43332329829245","12478.99","-0.24","EURd","SWAP","PROCESSED","2023-10-25 21:22:20","","AMD","Advanced Micro Devices Inc (Extended Hours)","",""
"43332327730833","12479.23","-0.19","EURd","SWAP","PROCESSED","2023-10-25 21:22:18","","AMD","Advanced Micro Devices Inc (Extended Hours)","",""
"43332327730786","12479.42","-0.05","EURd","SWAP","PROCESSED","2023-10-25 21:22:18","","AMD","Advanced Micro Devices Inc (Extended Hours)","",""
"43332264807314","12479.47","-0.22","EURd","SWAP","PROCESSED","2023-10-25 21:21:18","","TSM","Taiwan Semiconductor Manufacturing Co Ltd - ADR (Extended Hours)","",""
"43332264807264","12479.69","-0.22","EURd","SWAP","PROCESSED","2023-10-25 21:21:18","","TSM","Taiwan Semiconductor Manufacturing Co Ltd - ADR (Extended Hours)","",""
"43241662606328","12479.91","-0.27","EURd","SWAP","PROCESSED","2023-10-24 21:21:13","","TSLA","Tesla Inc (Extended Hours)","",""
"43241659458880","12480.18","-0.11","EURd","SWAP","PROCESSED","2023-10-24 21:21:10","","TSLA","Tesla Inc (Extended Hours)","",""
"43241659458508","12480.29","-0.16","EURd","SWAP","PROCESSED","2023-10-24 21:21:10","","TSLA","Tesla Inc (Extended Hours)","",""
"43241659458308","12480.45","-0.16","EURd","SWAP","PROCESSED","2023-10-24 21:21:10","","TSLA","Tesla Inc (Extended Hours)","",""
"43241636390880","12480.61","-0.21","EURd","SWAP","PROCESSED","2023-10-24 21:20:48","","AMD","Advanced Micro Devices Inc (Extended Hours)","",""
"43241636390820","12480.82","-0.06","EURd","SWAP","PROCESSED","2023-10-24 21:20:48","","AMD","Advanced Micro Devices Inc (Extended Hours)","",""
"43241621716826","12480.88","-0.23","EURd","SWAP","PROCESSED","2023-10-24 21:20:34","","TSM","Taiwan Semiconductor Manufacturing Co Ltd - ADR (Extended Hours)","",""
"43241608076244","12481.11","-0.11","EURd","SWAP","PROCESSED","2023-10-24 21:20:21","","NVDA","NVIDIA Corp (Extended Hours)","",""
"43241605977796","12481.22","-0.33","EURd","SWAP","PROCESSED","2023-10-24 21:20:19","","NVDA","NVIDIA Corp (Extended Hours)","",""
"43151244944269","12481.55","-0.2","EURd","SWAP","PROCESSED","2023-10-23 21:24:04","","AMD","Advanced Micro Devices Inc (Extended Hours)","",""
"43151244944244","12481.75","-0.06","EURd","SWAP","PROCESSED","2023-10-23 21:24:04","","AMD","Advanced Micro Devices Inc (Extended Hours)","",""
"43151229209078","12481.81","-0.22","EURd","SWAP","PROCESSED","2023-10-23 21:23:49","","TSM","Taiwan Semiconductor Manufacturing Co Ltd - ADR (Extended Hours)","",""
"43151221881705","12482.03","-0.11","EURd","SWAP","PROCESSED","2023-10-23 21:23:42","","TSLA","Tesla Inc (Extended Hours)","",""
"43151221881437","12482.14","-0.16","EURd","SWAP","PROCESSED","2023-10-23 21:23:42","","TSLA","Tesla Inc (Extended Hours)","",""
"43151221881322","12482.3","-0.16","EURd","SWAP","PROCESSED","2023-10-23 21:23:42","","TSLA","Tesla Inc (Extended Hours)","",""
"43151205094164","12482.46","-0.11","EURd","SWAP","PROCESSED","2023-10-23 21:23:26","","NVDA","NVIDIA Corp (Extended Hours)","",""
"43151204044489","12482.57","-0.32","EURd","SWAP","PROCESSED","2023-10-23 21:23:25","","NVDA","NVIDIA Corp (Extended Hours)","",""
"43143183499112","12482.89","32.19","EURd","TRADE","PROCESSED","2023-10-23 19:15:56","0015421d-0055-311e-0000-4cc5000ac48c_0015421d-0055-311e-0000-000080e63332","ETH/USD","Ethereum / USD","",""
"43143183499111","12450.7","15.33","EURd","TRADE","PROCESSED","2023-10-23 19:15:56","0015421d-0055-311e-0000-4cc5000ac48b_0015421d-0055-311e-0000-000080e5f6ad","ETH/USD","Ethereum / USD","",""
"43143183499110","12435.37","21.58","EURd","TRADE","PROCESSED","2023-10-23 19:15:56","0015421d-0055-311e-0000-4cc5000ac48a_0015421d-0055-311e-0000-000080e6601d","ETH/USD","Ethereum / USD","",""
"43143183499108","12413.79","53.96","EURd","TRADE","PROCESSED","2023-10-23 19:15:56","0015421d-0055-311e-0000-4cc5000ac489_0015421d-0055-311e-0000-000080e6601b","ETH/USD","Ethereum / USD","",""
"43143183499106","12359.83","92.83","EURd","TRADE","PROCESSED","2023-10-23 19:15:56","0015421d-0055-311e-0000-4cc5000ac488_0015421d-0055-311e-0000-000080e663b1","ETH/USD","Ethereum / USD","",""
"43143183499105","12267","-8.39","EURd","TRADE","PROCESSED","2023-10-23 19:15:56","0015421d-0055-311e-0000-4cc5000ac487_0015421d-0055-311e-0000-000080e61bdf","ETH/USD","Ethereum / USD","",""
"43143183499104","12275.39","24.19","EURd","TRADE","PROCESSED","2023-10-23 19:15:56","0015421d-0055-311e-0000-4cc5000ac486_0015421d-0055-311e-0000-000080e62549","ETH/USD","Ethereum / USD","",""
"43143183499103","12251.2","-8.39","EURd","TRADE","PROCESSED","2023-10-23 19:15:56","0015421d-0055-311e-0000-4cc5000ac485_0015421d-0055-311e-0000-000080e61bdd","ETH/USD","Ethereum / USD","",""
"43060652164236","12259.59","-0.11","EURd","SWAP","PROCESSED","2023-10-22 21:24:08","","TSLA","Tesla Inc (Extended Hours)","",""
"43060652164010","12259.7","-0.16","EURd","SWAP","PROCESSED","2023-10-22 21:24:08","","TSLA","Tesla Inc (Extended Hours)","",""
"43060651115173","12259.86","-0.16","EURd","SWAP","PROCESSED","2023-10-22 21:24:07","","TSLA","Tesla Inc (Extended Hours)","",""
"43060590309218","12260.02","-0.23","EURd","SWAP","PROCESSED","2023-10-22 21:23:09","","TSM","Taiwan Semiconductor Manufacturing Co Ltd - ADR (Extended Hours)","",""
"43060560947231","12260.25","-0.76","EURd","SWAP","PROCESSED","2023-10-22 21:22:41","","ETH/USD","Ethereum / USD","",""
"43060559898591","12261.01","-0.2","EURd","SWAP","PROCESSED","2023-10-22 21:22:40","","ETH/USD","Ethereum / USD","",""
"43060559898528","12261.21","-0.48","EURd","SWAP","PROCESSED","2023-10-22 21:22:40","","ETH/USD","Ethereum / USD","",""
"43060559898094","12261.69","-0.48","EURd","SWAP","PROCESSED","2023-10-22 21:22:40","","ETH/USD","Ethereum / USD","",""
"43060559897876","12262.17","-0.48","EURd","SWAP","PROCESSED","2023-10-22 21:22:40","","ETH/USD","Ethereum / USD","",""
"43060558849255","12262.65","-0.48","EURd","SWAP","PROCESSED","2023-10-22 21:22:39","","ETH/USD","Ethereum / USD","",""
"43060558849168","12263.13","-0.48","EURd","SWAP","PROCESSED","2023-10-22 21:22:39","","ETH/USD","Ethereum / USD","",""
"43060558848889","12263.61","-0.48","EURd","SWAP","PROCESSED","2023-10-22 21:22:39","","ETH/USD","Ethereum / USD","",""
"43060427770697","12264.09","-0.21","EURd","SWAP","PROCESSED","2023-10-22 21:20:34","","AMD","Advanced Micro Devices Inc (Extended Hours)","",""
"43060427770630","12264.3","-0.06","EURd","SWAP","PROCESSED","2023-10-22 21:20:34","","AMD","Advanced Micro Devices Inc (Extended Hours)","",""
"43060419393463","12264.36","-0.1","EURd","SWAP","PROCESSED","2023-10-22 21:20:26","","NVDA","NVIDIA Corp (Extended Hours)","",""
"43060416245636","12264.46","-0.31","EURd","SWAP","PROCESSED","2023-10-22 21:20:23","","NVDA","NVIDIA Corp (Extended Hours)","",""
"42970015358663","12264.77","-0.76","EURd","SWAP","PROCESSED","2023-10-21 21:23:30","","ETH/USD","Ethereum / USD","",""
"42970015358608","12265.53","-0.2","EURd","SWAP","PROCESSED","2023-10-21 21:23:30","","ETH/USD","Ethereum / USD","",""
"42970015358550","12265.73","-0.48","EURd","SWAP","PROCESSED","2023-10-21 21:23:30","","ETH/USD","Ethereum / USD","",""
"42970015358202","12266.21","-0.48","EURd","SWAP","PROCESSED","2023-10-21 21:23:30","","ETH/USD","Ethereum / USD","",""
"42970014309434","12266.69","-0.48","EURd","SWAP","PROCESSED","2023-10-21 21:23:29","","ETH/USD","Ethereum / USD","",""
"42970014309377","12267.17","-0.48","EURd","SWAP","PROCESSED","2023-10-21 21:23:29","","ETH/USD","Ethereum / USD","",""
"42970014309304","12267.65","-0.48","EURd","SWAP","PROCESSED","2023-10-21 21:23:29","","ETH/USD","Ethereum / USD","",""
"42970014309063","12268.13","-0.48","EURd","SWAP","PROCESSED","2023-10-21 21:23:29","","ETH/USD","Ethereum / USD","",""
"42969959792564","12268.61","-0.23","EURd","SWAP","PROCESSED","2023-10-21 21:22:37","","TSM","Taiwan Semiconductor Manufacturing Co Ltd - ADR (Extended Hours)","",""
"42969841300294","12268.84","-0.11","EURd","SWAP","PROCESSED","2023-10-21 21:20:44","","TSLA","Tesla Inc (Extended Hours)","",""
"42969841299940","12268.95","-0.16","EURd","SWAP","PROCESSED","2023-10-21 21:20:44","","TSLA","Tesla Inc (Extended Hours)","",""
"42969841299742","12269.11","-0.16","EURd","SWAP","PROCESSED","2023-10-21 21:20:44","","TSLA","Tesla Inc (Extended Hours)","",""
"42969829756563","12269.27","-0.1","EURd","SWAP","PROCESSED","2023-10-21 21:20:33","","NVDA","NVIDIA Corp (Extended Hours)","",""
"42969826609423","12269.37","-0.31","EURd","SWAP","PROCESSED","2023-10-21 21:20:30","","NVDA","NVIDIA Corp (Extended Hours)","",""
"42969814033998","12269.68","-0.21","EURd","SWAP","PROCESSED","2023-10-21 21:20:18","","AMD","Advanced Micro Devices Inc (Extended Hours)","",""
"42969814033952","12269.89","-0.06","EURd","SWAP","PROCESSED","2023-10-21 21:20:18","","AMD","Advanced Micro Devices Inc (Extended Hours)","",""
"42879416293309","12269.95","-0.23","EURd","SWAP","PROCESSED","2023-10-20 21:23:28","","TSM","Taiwan Semiconductor Manufacturing Co Ltd - ADR (Extended Hours)","",""
"42879342888200","12270.18","-0.75","EURd","SWAP","PROCESSED","2023-10-20 21:22:18","","ETH/USD","Ethereum / USD","",""
"42879341839513","12270.93","-0.19","EURd","SWAP","PROCESSED","2023-10-20 21:22:17","","ETH/USD","Ethereum / USD","",""
"42879341839433","12271.12","-0.47","EURd","SWAP","PROCESSED","2023-10-20 21:22:17","","ETH/USD","Ethereum / USD","",""
"42879341838996","12271.59","-0.47","EURd","SWAP","PROCESSED","2023-10-20 21:22:17","","ETH/USD","Ethereum / USD","",""
"42879341838794","12272.06","-0.47","EURd","SWAP","PROCESSED","2023-10-20 21:22:17","","ETH/USD","Ethereum / USD","",""
"42879341838724","12272.53","-0.47","EURd","SWAP","PROCESSED","2023-10-20 21:22:17","","ETH/USD","Ethereum / USD","",""
"42879340790091","12273","-0.47","EURd","SWAP","PROCESSED","2023-10-20 21:22:16","","ETH/USD","Ethereum / USD","",""
"42879340789774","12273.47","-0.47","EURd","SWAP","PROCESSED","2023-10-20 21:22:16","","ETH/USD","Ethereum / USD","",""
"42879239083470","12273.94","-0.1","EURd","SWAP","PROCESSED","2023-10-20 21:20:39","","NVDA","NVIDIA Corp (Extended Hours)","",""
"42879238033419","12274.04","-0.31","EURd","SWAP","PROCESSED","2023-10-20 21:20:38","","NVDA","NVIDIA Corp (Extended Hours)","",""
"42879223360449","12274.35","-0.11","EURd","SWAP","PROCESSED","2023-10-20 21:20:24","","TSLA","Tesla Inc (Extended Hours)","",""
"42879223360035","12274.46","-0.16","EURd","SWAP","PROCESSED","2023-10-20 21:20:24","","TSLA","Tesla Inc (Extended Hours)","",""
"42879222311279","12274.62","-0.16","EURd","SWAP","PROCESSED","2023-10-20 21:20:23","","TSLA","Tesla Inc (Extended Hours)","",""
"42879204488994","12274.78","-0.21","EURd","SWAP","PROCESSED","2023-10-20 21:20:06","","AMD","Advanced Micro Devices Inc (Extended Hours)","",""
"42879204488938","12274.99","-0.06","EURd","SWAP","PROCESSED","2023-10-20 21:20:06","","AMD","Advanced Micro Devices Inc (Extended Hours)","",""
"42788879091535","12275.05","-0.11","EURd","SWAP","PROCESSED","2023-10-19 21:24:25","","TSLA","Tesla Inc (Extended Hours)","",""
"42788879091266","12275.16","-0.17","EURd","SWAP","PROCESSED","2023-10-19 21:24:25","","TSLA","Tesla Inc (Extended Hours)","",""
"42788878042561","12275.33","-0.17","EURd","SWAP","PROCESSED","2023-10-19 21:24:24","","TSLA","Tesla Inc (Extended Hours)","",""
"42788857076683","12275.5","-0.24","EURd","SWAP","PROCESSED","2023-10-19 21:24:04","","TSM","Taiwan Semiconductor Manufacturing Co Ltd - ADR (Extended Hours)","",""
"42788702938228","12275.74","-0.74","EURd","SWAP","PROCESSED","2023-10-19 21:21:37","","ETH/USD","Ethereum / USD","",""
"42788702938084","12276.48","-0.19","EURd","SWAP","PROCESSED","2023-10-19 21:21:37","","ETH/USD","Ethereum / USD","",""
"42788702938048","12276.67","-0.46","EURd","SWAP","PROCESSED","2023-10-19 21:21:37","","ETH/USD","Ethereum / USD","",""
"42788701888984","12277.13","-0.46","EURd","SWAP","PROCESSED","2023-10-19 21:21:36","","ETH/USD","Ethereum / USD","",""
"42788701888817","12277.59","-0.46","EURd","SWAP","PROCESSED","2023-10-19 21:21:36","","ETH/USD","Ethereum / USD","",""
"42788701888763","12278.05","-0.46","EURd","SWAP","PROCESSED","2023-10-19 21:21:36","","ETH/USD","Ethereum / USD","",""
"42788701888697","12278.51","-0.46","EURd","SWAP","PROCESSED","2023-10-19 21:21:36","","ETH/USD","Ethereum / USD","",""
"42788700839859","12278.97","-0.46","EURd","SWAP","PROCESSED","2023-10-19 21:21:35","","ETH/USD","Ethereum / USD","",""
"42788635822369","12279.43","-0.1","EURd","SWAP","PROCESSED","2023-10-19 21:20:33","","NVDA","NVIDIA Corp (Extended Hours)","",""
"42788632674954","12279.53","-0.31","EURd","SWAP","PROCESSED","2023-10-19 21:20:30","","NVDA","NVIDIA Corp (Extended Hours)","",""
"42788603314614","12279.84","-0.21","EURd","SWAP","PROCESSED","2023-10-19 21:20:02","","AMD","Advanced Micro Devices Inc (Extended Hours)","",""
"42788602265945","12280.05","-0.06","EURd","SWAP","PROCESSED","2023-10-19 21:20:01","","AMD","Advanced Micro Devices Inc (Extended Hours)","",""
"42698232843434","12280.11","-0.12","EURd","SWAP","PROCESSED","2023-10-18 21:23:38","","TSLA","Tesla Inc (Extended Hours)","",""
"42698231794441","12280.23","-0.19","EURd","SWAP","PROCESSED","2023-10-18 21:23:37","","TSLA","Tesla Inc (Extended Hours)","",""
"42698231794299","12280.42","-0.19","EURd","SWAP","PROCESSED","2023-10-18 21:23:37","","TSLA","Tesla Inc (Extended Hours)","",""
"42698220268487","12280.61","-0.21","EURd","SWAP","PROCESSED","2023-10-18 21:23:26","","AMD","Advanced Micro Devices Inc (Extended Hours)","",""
"42698220268417","12280.82","-0.06","EURd","SWAP","PROCESSED","2023-10-18 21:23:26","","AMD","Advanced Micro Devices Inc (Extended Hours)","",""
"42698181461058","12280.88","-0.23","EURd","SWAP","PROCESSED","2023-10-18 21:22:49","","TSM","Taiwan Semiconductor Manufacturing Co Ltd - ADR (Extended Hours)","",""
"42698156309290","12281.11","-0.73","EURd","SWAP","PROCESSED","2023-10-18 21:22:25","","ETH/USD","Ethereum / USD","",""
"42698156309179","12281.84","-0.19","EURd","SWAP","PROCESSED","2023-10-18 21:22:25","","ETH/USD","Ethereum / USD","",""
"42698156309121","12282.03","-0.46","EURd","SWAP","PROCESSED","2023-10-18 21:22:25","","ETH/USD","Ethereum / USD","",""
"42698155260140","12282.49","-0.46","EURd","SWAP","PROCESSED","2023-10-18 21:22:24","","ETH/USD","Ethereum / USD","",""
"42698155259946","12282.95","-0.46","EURd","SWAP","PROCESSED","2023-10-18 21:22:24","","ETH/USD","Ethereum / USD","",""
"42698155259883","12283.41","-0.46","EURd","SWAP","PROCESSED","2023-10-18 21:22:24","","ETH/USD","Ethereum / USD","",""
"42698155259825","12283.87","-0.46","EURd","SWAP","PROCESSED","2023-10-18 21:22:24","","ETH/USD","Ethereum / USD","",""
"42698155259521","12284.33","-0.46","EURd","SWAP","PROCESSED","2023-10-18 21:22:24","","ETH/USD","Ethereum / USD","",""
"42698064019859","12284.79","-0.11","EURd","SWAP","PROCESSED","2023-10-18 21:20:57","","NVDA","NVIDIA Corp (Extended Hours)","",""
"42698059839333","12284.9","-0.32","EURd","SWAP","PROCESSED","2023-10-18 21:20:53","","NVDA","NVIDIA Corp (Extended Hours)","",""
"42607666292773","12285.22","-0.13","EURd","SWAP","PROCESSED","2023-10-17 21:24:07","","TSLA","Tesla Inc (Extended Hours)","",""
"42607665243775","12285.35","-0.19","EURd","SWAP","PROCESSED","2023-10-17 21:24:06","","TSLA","Tesla Inc (Extended Hours)","",""
"42607665243649","12285.54","-0.19","EURd","SWAP","PROCESSED","2023-10-17 21:24:06","","TSLA","Tesla Inc (Extended Hours)","",""
"42607648457535","12285.73","-0.11","EURd","SWAP","PROCESSED","2023-10-17 21:23:50","","NVDA","NVIDIA Corp (Extended Hours)","",""
"42607645326729","12285.84","-0.33","EURd","SWAP","PROCESSED","2023-10-17 21:23:47","","NVDA","NVIDIA Corp (Extended Hours)","",""
"42607603371782","12286.17","-0.21","EURd","SWAP","PROCESSED","2023-10-17 21:23:07","","AMD","Advanced Micro Devices Inc (Extended Hours)","",""
"42607603371682","12286.38","-0.06","EURd","SWAP","PROCESSED","2023-10-17 21:23:07","","AMD","Advanced Micro Devices Inc (Extended Hours)","",""
"42607560383366","12286.44","-0.23","EURd","SWAP","PROCESSED","2023-10-17 21:22:26","","TSM","Taiwan Semiconductor Manufacturing Co Ltd - ADR (Extended Hours)","",""
"42607529970211","12286.67","-0.74","EURd","SWAP","PROCESSED","2023-10-17 21:21:57","","ETH/USD","Ethereum / USD","",""
"42607529970083","12287.41","-0.19","EURd","SWAP","PROCESSED","2023-10-17 21:21:57","","ETH/USD","Ethereum / USD","",""
"42607529970029","12287.6","-0.46","EURd","SWAP","PROCESSED","2023-10-17 21:21:57","","ETH/USD","Ethereum / USD","",""
"42607528920971","12288.06","-0.46","EURd","SWAP","PROCESSED","2023-10-17 21:21:56","","ETH/USD","Ethereum / USD","",""
"42607528920767","12288.52","-0.46","EURd","SWAP","PROCESSED","2023-10-17 21:21:56","","ETH/USD","Ethereum / USD","",""
"42607528920712","12288.98","-0.46","EURd","SWAP","PROCESSED","2023-10-17 21:21:56","","ETH/USD","Ethereum / USD","",""
"42607528920654","12289.44","-0.46","EURd","SWAP","PROCESSED","2023-10-17 21:21:56","","ETH/USD","Ethereum / USD","",""
"42607527871748","12289.9","-0.46","EURd","SWAP","PROCESSED","2023-10-17 21:21:55","","ETH/USD","Ethereum / USD","",""
"42516910982525","12290.36","-0.12","EURd","SWAP","PROCESSED","2023-10-16 21:21:36","","NVDA","NVIDIA Corp (Extended Hours)","",""
"42516908899922","12290.48","-0.35","EURd","SWAP","PROCESSED","2023-10-16 21:21:34","","NVDA","NVIDIA Corp (Extended Hours)","",""
"42516902604229","12290.83","-0.13","EURd","SWAP","PROCESSED","2023-10-16 21:21:28","","TSLA","Tesla Inc (Extended Hours)","",""
"42516901554818","12290.96","-0.19","EURd","SWAP","PROCESSED","2023-10-16 21:21:27","","TSLA","Tesla Inc (Extended Hours)","",""
"42516901554652","12291.15","-0.19","EURd","SWAP","PROCESSED","2023-10-16 21:21:27","","TSLA","Tesla Inc (Extended Hours)","",""
"42516876388437","12291.34","-0.23","EURd","SWAP","PROCESSED","2023-10-16 21:21:03","","TSM","Taiwan Semiconductor Manufacturing Co Ltd - ADR (Extended Hours)","",""
"42516842826522","12291.57","-0.75","EURd","SWAP","PROCESSED","2023-10-16 21:20:31","","ETH/USD","Ethereum / USD","",""
"42516842826369","12292.32","-0.19","EURd","SWAP","PROCESSED","2023-10-16 21:20:31","","ETH/USD","Ethereum / USD","",""
"42516842826319","12292.51","-0.46","EURd","SWAP","PROCESSED","2023-10-16 21:20:31","","ETH/USD","Ethereum / USD","",""
"42516841777276","12292.97","-0.46","EURd","SWAP","PROCESSED","2023-10-16 21:20:30","","ETH/USD","Ethereum / USD","",""
"42516841777094","12293.43","-0.46","EURd","SWAP","PROCESSED","2023-10-16 21:20:30","","ETH/USD","Ethereum / USD","",""
"42516841777021","12293.89","-0.46","EURd","SWAP","PROCESSED","2023-10-16 21:20:29","","ETH/USD","Ethereum / USD","",""
"42516840728386","12294.35","-0.46","EURd","SWAP","PROCESSED","2023-10-16 21:20:29","","ETH/USD","Ethereum / USD","",""
"42516840728058","12294.81","-0.46","EURd","SWAP","PROCESSED","2023-10-16 21:20:29","","ETH/USD","Ethereum / USD","",""
"42516811382251","12295.27","-0.22","EURd","SWAP","PROCESSED","2023-10-16 21:20:01","","AMD","Advanced Micro Devices Inc (Extended Hours)","",""
"42516811382169","12295.49","-0.06","EURd","SWAP","PROCESSED","2023-10-16 21:20:01","","AMD","Advanced Micro Devices Inc (Extended Hours)","",""
"42426433566423","12295.55","-0.19","EURd","SWAP","PROCESSED","2023-10-15 21:23:30","","TSLA","Tesla Inc (Extended Hours)","",""
"42426432517637","12295.74","-0.19","EURd","SWAP","PROCESSED","2023-10-15 21:23:29","","TSLA","Tesla Inc (Extended Hours)","",""
"42426314015829","12295.93","-0.11","EURd","SWAP","PROCESSED","2023-10-15 21:21:36","","NVDA","NVIDIA Corp (Extended Hours)","",""
"42426310884354","12296.04","-0.34","EURd","SWAP","PROCESSED","2023-10-15 21:21:33","","NVDA","NVIDIA Corp (Extended Hours)","",""
"42426297245385","12296.38","-0.23","EURd","SWAP","PROCESSED","2023-10-15 21:21:20","","TSM","Taiwan Semiconductor Manufacturing Co Ltd - ADR (Extended Hours)","",""
"42426294097656","12296.61","-0.73","EURd","SWAP","PROCESSED","2023-10-15 21:21:17","","ETH/USD","Ethereum / USD","",""
"42426293048954","12297.34","-0.19","EURd","SWAP","PROCESSED","2023-10-15 21:21:16","","ETH/USD","Ethereum / USD","",""
"42426293048901","12297.53","-0.47","EURd","SWAP","PROCESSED","2023-10-15 21:21:16","","ETH/USD","Ethereum / USD","",""
"42426293048380","12298","-0.47","EURd","SWAP","PROCESSED","2023-10-15 21:21:16","","ETH/USD","Ethereum / USD","",""
"42426291999611","12298.47","-0.47","EURd","SWAP","PROCESSED","2023-10-15 21:21:15","","ETH/USD","Ethereum / USD","",""
"42426291999542","12298.94","-0.47","EURd","SWAP","PROCESSED","2023-10-15 21:21:15","","ETH/USD","Ethereum / USD","",""
"42426291999472","12299.41","-0.47","EURd","SWAP","PROCESSED","2023-10-15 21:21:15","","ETH/USD","Ethereum / USD","",""
"42426290950468","12299.88","-0.47","EURd","SWAP","PROCESSED","2023-10-15 21:21:14","","ETH/USD","Ethereum / USD","",""
"42426221750013","12300.35","-0.21","EURd","SWAP","PROCESSED","2023-10-15 21:20:08","","AMD","Advanced Micro Devices Inc (Extended Hours)","",""
"42426220701359","12300.56","-0.06","EURd","SWAP","PROCESSED","2023-10-15 21:20:07","","AMD","Advanced Micro Devices Inc (Extended Hours)","",""
"42335870141348","12300.62","-0.19","EURd","SWAP","PROCESSED","2023-10-14 21:24:02","","TSLA","Tesla Inc (Extended Hours)","",""
"42335870141276","12300.81","-0.19","EURd","SWAP","PROCESSED","2023-10-14 21:24:02","","TSLA","Tesla Inc (Extended Hours)","",""
"42335750605356","12301","-0.21","EURd","SWAP","PROCESSED","2023-10-14 21:22:08","","AMD","Advanced Micro Devices Inc (Extended Hours)","",""
"42335750605291","12301.21","-0.06","EURd","SWAP","PROCESSED","2023-10-14 21:22:08","","AMD","Advanced Micro Devices Inc (Extended Hours)","",""
"42335739078586","12301.27","-0.11","EURd","SWAP","PROCESSED","2023-10-14 21:21:57","","NVDA","NVIDIA Corp (Extended Hours)","",""
"42335735930771","12301.38","-0.34","EURd","SWAP","PROCESSED","2023-10-14 21:21:54","","NVDA","NVIDIA Corp (Extended Hours)","",""
"42335719157986","12301.72","-0.23","EURd","SWAP","PROCESSED","2023-10-14 21:21:38","","TSM","Taiwan Semiconductor Manufacturing Co Ltd - ADR (Extended Hours)","",""
"42335714960310","12301.95","-0.73","EURd","SWAP","PROCESSED","2023-10-14 21:21:34","","ETH/USD","Ethereum / USD","",""
"42335714960191","12302.68","-0.19","EURd","SWAP","PROCESSED","2023-10-14 21:21:34","","ETH/USD","Ethereum / USD","",""
"42335714960122","12302.87","-0.47","EURd","SWAP","PROCESSED","2023-10-14 21:21:34","","ETH/USD","Ethereum / USD","",""
"42335713911026","12303.34","-0.47","EURd","SWAP","PROCESSED","2023-10-14 21:21:33","","ETH/USD","Ethereum / USD","",""
"42335713910828","12303.81","-0.47","EURd","SWAP","PROCESSED","2023-10-14 21:21:33","","ETH/USD","Ethereum / USD","",""
"42335713910763","12304.28","-0.47","EURd","SWAP","PROCESSED","2023-10-14 21:21:33","","ETH/USD","Ethereum / USD","",""
"42335713910719","12304.75","-0.47","EURd","SWAP","PROCESSED","2023-10-14 21:21:33","","ETH/USD","Ethereum / USD","",""
"42335712861714","12305.22","-0.47","EURd","SWAP","PROCESSED","2023-10-14 21:21:32","","ETH/USD","Ethereum / USD","",""
"42245243819182","12305.69","-0.21","EURd","SWAP","PROCESSED","2023-10-13 21:23:34","","AMD","Advanced Micro Devices Inc (Extended Hours)","",""
"42245243819145","12305.9","-0.06","EURd","SWAP","PROCESSED","2023-10-13 21:23:34","","AMD","Advanced Micro Devices Inc (Extended Hours)","",""
"42245155742524","12305.96","-0.73","EURd","SWAP","PROCESSED","2023-10-13 21:22:10","","ETH/USD","Ethereum / USD","",""
"42245155742414","12306.69","-0.19","EURd","SWAP","PROCESSED","2023-10-13 21:22:10","","ETH/USD","Ethereum / USD","",""
"42245155742346","12306.88","-0.47","EURd","SWAP","PROCESSED","2023-10-13 21:22:10","","ETH/USD","Ethereum / USD","",""
"42245154693283","12307.35","-0.47","EURd","SWAP","PROCESSED","2023-10-13 21:22:09","","ETH/USD","Ethereum / USD","",""
"42245154693102","12307.82","-0.47","EURd","SWAP","PROCESSED","2023-10-13 21:22:09","","ETH/USD","Ethereum / USD","",""
"42245154693034","12308.29","-0.47","EURd","SWAP","PROCESSED","2023-10-13 21:22:09","","ETH/USD","Ethereum / USD","",""
"42245153644388","12308.76","-0.47","EURd","SWAP","PROCESSED","2023-10-13 21:22:08","","ETH/USD","Ethereum / USD","",""
"42245153643754","12309.23","-0.47","EURd","SWAP","PROCESSED","2023-10-13 21:22:08","","ETH/USD","Ethereum / USD","",""
"42245126377873","12309.7","-0.23","EURd","SWAP","PROCESSED","2023-10-13 21:21:42","","TSM","Taiwan Semiconductor Manufacturing Co Ltd - ADR (Extended Hours)","",""
"42245071861475","12309.93","-0.11","EURd","SWAP","PROCESSED","2023-10-13 21:20:50","","NVDA","NVIDIA Corp (Extended Hours)","",""
"42245068713749","12310.04","-0.34","EURd","SWAP","PROCESSED","2023-10-13 21:20:47","","NVDA","NVIDIA Corp (Extended Hours)","",""
"42245049841891","12310.38","-0.19","EURd","SWAP","PROCESSED","2023-10-13 21:20:29","","TSLA","Tesla Inc (Extended Hours)","",""
"42245048793053","12310.57","-0.19","EURd","SWAP","PROCESSED","2023-10-13 21:20:28","","TSLA","Tesla Inc (Extended Hours)","",""
"42216183581657","12310.76","10.64","EURd","TRADE","PROCESSED","2023-10-13 13:41:40","000144cd-0055-311e-0000-4cbb000e0a2d_000144cd-0055-311e-0000-0000804c011a","TSM","Taiwan Semiconductor Manufacturing Co Ltd - ADR (Extended Hours)","",""
"42154639509817","12300.12","-0.35","EURd","SWAP","PROCESSED","2023-10-12 21:23:27","","NVDA","NVIDIA Corp (Extended Hours)","",""
"42154576601806","12300.47","-0.72","EURd","SWAP","PROCESSED","2023-10-12 21:22:27","","ETH/USD","Ethereum / USD","",""
"42154576601655","12301.19","-0.18","EURd","SWAP","PROCESSED","2023-10-12 21:22:27","","ETH/USD","Ethereum / USD","",""
"42154576601587","12301.37","-0.46","EURd","SWAP","PROCESSED","2023-10-12 21:22:27","","ETH/USD","Ethereum / USD","",""
"42154575552567","12301.83","-0.46","EURd","SWAP","PROCESSED","2023-10-12 21:22:26","","ETH/USD","Ethereum / USD","",""
"42154575552347","12302.29","-0.46","EURd","SWAP","PROCESSED","2023-10-12 21:22:26","","ETH/USD","Ethereum / USD","",""
"42154575552286","12302.75","-0.46","EURd","SWAP","PROCESSED","2023-10-12 21:22:26","","ETH/USD","Ethereum / USD","",""
"42154575552217","12303.21","-0.46","EURd","SWAP","PROCESSED","2023-10-12 21:22:26","","ETH/USD","Ethereum / USD","",""
"42154574503249","12303.67","-0.46","EURd","SWAP","PROCESSED","2023-10-12 21:22:25","","ETH/USD","Ethereum / USD","",""
"42154560877519","12304.13","-0.24","EURd","SWAP","PROCESSED","2023-10-12 21:22:12","","TSM","Taiwan Semiconductor Manufacturing Co Ltd - ADR (Extended Hours)","",""
"42154560877470","12304.37","-0.24","EURd","SWAP","PROCESSED","2023-10-12 21:22:12","","TSM","Taiwan Semiconductor Manufacturing Co Ltd - ADR (Extended Hours)","",""
"42154475931581","12304.61","-0.2","EURd","SWAP","PROCESSED","2023-10-12 21:20:51","","TSLA","Tesla Inc (Extended Hours)","",""
"42154442385867","12304.81","-0.22","EURd","SWAP","PROCESSED","2023-10-12 21:20:19","","AMD","Advanced Micro Devices Inc (Extended Hours)","",""
"42154442385810","12305.03","-0.06","EURd","SWAP","PROCESSED","2023-10-12 21:20:19","","AMD","Advanced Micro Devices Inc (Extended Hours)","",""
"42104762941976","12305.09","43.75","EURd","TRADE","PROCESSED","2023-10-12 08:10:41","00396101-0055-311e-0000-4cba0001b24d_00396101-0055-311e-0000-000080262f20","NVDA","NVIDIA Corp (Extended Hours)","",""
"42063974391560","12261.34","-0.73","EURd","SWAP","PROCESSED","2023-10-11 21:22:22","","ETH/USD","Ethereum / USD","",""
"42063974391348","12262.07","-0.19","EURd","SWAP","PROCESSED","2023-10-11 21:22:22","","ETH/USD","Ethereum / USD","",""
"42063974391295","12262.26","-0.46","EURd","SWAP","PROCESSED","2023-10-11 21:22:22","","ETH/USD","Ethereum / USD","",""
"42063973342185","12262.72","-0.46","EURd","SWAP","PROCESSED","2023-10-11 21:22:21","","ETH/USD","Ethereum / USD","",""
"42063973341959","12263.18","-0.46","EURd","SWAP","PROCESSED","2023-10-11 21:22:21","","ETH/USD","Ethereum / USD","",""
"42063973341858","12263.64","-0.46","EURd","SWAP","PROCESSED","2023-10-11 21:22:21","","ETH/USD","Ethereum / USD","",""
"42063973341798","12264.1","-0.46","EURd","SWAP","PROCESSED","2023-10-11 21:22:21","","ETH/USD","Ethereum / USD","",""
"42063972292811","12264.56","-0.46","EURd","SWAP","PROCESSED","2023-10-11 21:22:20","","ETH/USD","Ethereum / USD","",""
"42063943978519","12265.02","-0.24","EURd","SWAP","PROCESSED","2023-10-11 21:21:53","","TSM","Taiwan Semiconductor Manufacturing Co Ltd - ADR (Extended Hours)","",""
"42063943978366","12265.26","-0.24","EURd","SWAP","PROCESSED","2023-10-11 21:21:53","","TSM","Taiwan Semiconductor Manufacturing Co Ltd - ADR (Extended Hours)","",""
"42063928254883","12265.5","-0.35","EURd","SWAP","PROCESSED","2023-10-11 21:21:38","","NVDA","NVIDIA Corp (Extended Hours)","",""
"42063927206007","12265.85","-0.35","EURd","SWAP","PROCESSED","2023-10-11 21:21:37","","NVDA","NVIDIA Corp (Extended Hours)","",""
"42063842278125","12266.2","-0.22","EURd","SWAP","PROCESSED","2023-10-11 21:20:16","","AMD","Advanced Micro Devices Inc (Extended Hours)","",""
"42063842278034","12266.42","-0.06","EURd","SWAP","PROCESSED","2023-10-11 21:20:16","","AMD","Advanced Micro Devices Inc (Extended Hours)","",""
"41973440333699","12266.48","-0.23","EURd","SWAP","PROCESSED","2023-10-10 21:23:22","","TSM","Taiwan Semiconductor Manufacturing Co Ltd - ADR (Extended Hours)","",""
"41973440333671","12266.71","-0.23","EURd","SWAP","PROCESSED","2023-10-10 21:23:22","","TSM","Taiwan Semiconductor Manufacturing Co Ltd - ADR (Extended Hours)","",""
"41973365885759","12266.94","-0.74","EURd","SWAP","PROCESSED","2023-10-10 21:22:11","","ETH/USD","Ethereum / USD","",""
"41973364836939","12267.68","-0.19","EURd","SWAP","PROCESSED","2023-10-10 21:22:10","","ETH/USD","Ethereum / USD","",""
"41973364836878","12267.87","-0.46","EURd","SWAP","PROCESSED","2023-10-10 21:22:10","","ETH/USD","Ethereum / USD","",""
"41973363787676","12268.33","-0.46","EURd","SWAP","PROCESSED","2023-10-10 21:22:09","","ETH/USD","Ethereum / USD","",""
"41973363787502","12268.79","-0.46","EURd","SWAP","PROCESSED","2023-10-10 21:22:09","","ETH/USD","Ethereum / USD","",""
"41973363787368","12269.25","-0.46","EURd","SWAP","PROCESSED","2023-10-10 21:22:09","","ETH/USD","Ethereum / USD","",""
"41973363787311","12269.71","-0.46","EURd","SWAP","PROCESSED","2023-10-10 21:22:09","","ETH/USD","Ethereum / USD","",""
"41973362738303","12270.17","-0.46","EURd","SWAP","PROCESSED","2023-10-10 21:22:08","","ETH/USD","Ethereum / USD","",""
"41973287243022","12270.63","-0.34","EURd","SWAP","PROCESSED","2023-10-10 21:20:56","","NVDA","NVIDIA Corp (Extended Hours)","",""
"41973287242693","12270.97","-0.34","EURd","SWAP","PROCESSED","2023-10-10 21:20:56","","NVDA","NVIDIA Corp (Extended Hours)","",""
"41973276766987","12271.31","-0.22","EURd","SWAP","PROCESSED","2023-10-10 21:20:46","","AMD","Advanced Micro Devices Inc (Extended Hours)","",""
"41973276766919","12271.53","-0.06","EURd","SWAP","PROCESSED","2023-10-10 21:20:46","","AMD","Advanced Micro Devices Inc (Extended Hours)","",""
"41950377954291","12271.59","5.57","EURd","TRADE","PROCESSED","2023-10-10 15:16:48","00396101-0055-311e-0000-4cb8000a0b9a_00396101-0055-311e-0000-000080269e61","NVDA","NVIDIA Corp (Extended Hours)","",""
"41882837082102","12266.02","-0.22","EURd","SWAP","PROCESSED","2023-10-09 21:23:16","","AMD","Advanced Micro Devices Inc (Extended Hours)","",""
"41882837082036","12266.24","-0.06","EURd","SWAP","PROCESSED","2023-10-09 21:23:16","","AMD","Advanced Micro Devices Inc (Extended Hours)","",""
"41882743761629","12266.3","-0.11","EURd","SWAP","PROCESSED","2023-10-09 21:21:47","","NVDA","NVIDIA Corp (Extended Hours)","",""
"41882740613883","12266.41","-0.34","EURd","SWAP","PROCESSED","2023-10-09 21:21:44","","NVDA","NVIDIA Corp (Extended Hours)","",""
"41882740613519","12266.75","-0.34","EURd","SWAP","PROCESSED","2023-10-09 21:21:44","","NVDA","NVIDIA Corp (Extended Hours)","",""
"41882675605391","12267.09","-0.74","EURd","SWAP","PROCESSED","2023-10-09 21:20:42","","ETH/USD","Ethereum / USD","",""
"41882675605148","12267.83","-0.19","EURd","SWAP","PROCESSED","2023-10-09 21:20:42","","ETH/USD","Ethereum / USD","",""
"41882675605074","12268.02","-0.46","EURd","SWAP","PROCESSED","2023-10-09 21:20:42","","ETH/USD","Ethereum / USD","",""
"41882674555816","12268.48","-0.46","EURd","SWAP","PROCESSED","2023-10-09 21:20:41","","ETH/USD","Ethereum / USD","",""
"41882673507062","12268.94","-0.46","EURd","SWAP","PROCESSED","2023-10-09 21:20:40","","ETH/USD","Ethereum / USD","",""
"41882673506919","12269.4","-0.46","EURd","SWAP","PROCESSED","2023-10-09 21:20:40","","ETH/USD","Ethereum / USD","",""
"41882673506858","12269.86","-0.46","EURd","SWAP","PROCESSED","2023-10-09 21:20:40","","ETH/USD","Ethereum / USD","",""
"41882673506361","12270.32","-0.46","EURd","SWAP","PROCESSED","2023-10-09 21:20:40","","ETH/USD","Ethereum / USD","",""
"41882645194291","12270.78","-0.23","EURd","SWAP","PROCESSED","2023-10-09 21:20:13","","TSM","Taiwan Semiconductor Manufacturing Co Ltd - ADR (Extended Hours)","",""
"41882645194233","12271.01","-0.23","EURd","SWAP","PROCESSED","2023-10-09 21:20:13","","TSM","Taiwan Semiconductor Manufacturing Co Ltd - ADR (Extended Hours)","",""
"41875198206339","12271.24","10.64","EURd","TRADE","PROCESSED","2023-10-09 19:21:51","00513301-0055-311e-0000-4cb7000c74be_00513301-0055-311e-0000-0000808846e4","TSLA","Tesla Inc (Extended Hours)","",""
"41875198206338","12260.6","5.83","EURd","TRADE","PROCESSED","2023-10-09 19:21:51","00513301-0055-311e-0000-4cb7000c74bd_00513301-0055-311e-0000-00008088530e","TSLA","Tesla Inc (Extended Hours)","",""
"41850785258525","12254.77","-9.3","EURd","TRADE","PROCESSED","2023-10-09 12:53:49","00001344-0055-311e-0000-4cb70000ea9e_00001344-0055-311e-0000-000080240f7f","AMD","Advanced Micro Devices Inc (Extended Hours)","",""
"41792283112208","12264.07","-0.14","EURd","SWAP","PROCESSED","2023-10-08 21:23:57","","AMD","Advanced Micro Devices Inc (Extended Hours)","",""
"41792283111978","12264.21","-0.22","EURd","SWAP","PROCESSED","2023-10-08 21:23:57","","AMD","Advanced Micro Devices Inc (Extended Hours)","",""
"41792283111951","12264.43","-0.06","EURd","SWAP","PROCESSED","2023-10-08 21:23:57","","AMD","Advanced Micro Devices Inc (Extended Hours)","",""
"41792228582803","12264.49","-0.34","EURd","SWAP","PROCESSED","2023-10-08 21:23:05","","NVDA","NVIDIA Corp (Extended Hours)","",""
"41792227533895","12264.83","-0.34","EURd","SWAP","PROCESSED","2023-10-08 21:23:04","","NVDA","NVIDIA Corp (Extended Hours)","",""
"41792224386204","12265.17","-0.48","EURd","SWAP","PROCESSED","2023-10-08 21:23:01","","ETH/USD","Ethereum / USD","",""
"41792224386034","12265.65","-0.48","EURd","SWAP","PROCESSED","2023-10-08 21:23:01","","ETH/USD","Ethereum / USD","",""
"41792224385896","12266.13","-0.48","EURd","SWAP","PROCESSED","2023-10-08 21:23:01","","ETH/USD","Ethereum / USD","",""
"41792224385851","12266.61","-0.48","EURd","SWAP","PROCESSED","2023-10-08 21:23:01","","ETH/USD","Ethereum / USD","",""
"41792223336752","12267.09","-0.48","EURd","SWAP","PROCESSED","2023-10-08 21:23:00","","ETH/USD","Ethereum / USD","",""
"41792177198201","12267.57","-0.33","EURd","SWAP","PROCESSED","2023-10-08 21:22:16","","TSLA","Tesla Inc (Extended Hours)","",""
"41792072351308","12267.9","-0.23","EURd","SWAP","PROCESSED","2023-10-08 21:20:36","","TSM","Taiwan Semiconductor Manufacturing Co Ltd - ADR (Extended Hours)","",""
"41792072351272","12268.13","-0.23","EURd","SWAP","PROCESSED","2023-10-08 21:20:36","","TSM","Taiwan Semiconductor Manufacturing Co Ltd - ADR (Extended Hours)","",""
"41701672512300","12268.36","-0.14","EURd","SWAP","PROCESSED","2023-10-07 21:23:44","","AMD","Advanced Micro Devices Inc (Extended Hours)","",""
"41701671463402","12268.5","-0.22","EURd","SWAP","PROCESSED","2023-10-07 21:23:43","","AMD","Advanced Micro Devices Inc (Extended Hours)","",""
"41701671463356","12268.72","-0.06","EURd","SWAP","PROCESSED","2023-10-07 21:23:43","","AMD","Advanced Micro Devices Inc (Extended Hours)","",""
"41701584435019","12268.78","-0.23","EURd","SWAP","PROCESSED","2023-10-07 21:22:20","","TSM","Taiwan Semiconductor Manufacturing Co Ltd - ADR (Extended Hours)","",""
"41701584434933","12269.01","-0.23","EURd","SWAP","PROCESSED","2023-10-07 21:22:20","","TSM","Taiwan Semiconductor Manufacturing Co Ltd - ADR (Extended Hours)","",""
"41701563464707","12269.24","-0.34","EURd","SWAP","PROCESSED","2023-10-07 21:22:00","","NVDA","NVIDIA Corp (Extended Hours)","",""
"41701563464388","12269.58","-0.34","EURd","SWAP","PROCESSED","2023-10-07 21:22:00","","NVDA","NVIDIA Corp (Extended Hours)","",""
"41701548774237","12269.92","-0.48","EURd","SWAP","PROCESSED","2023-10-07 21:21:46","","ETH/USD","Ethereum / USD","",""
"41701548773940","12270.4","-0.48","EURd","SWAP","PROCESSED","2023-10-07 21:21:46","","ETH/USD","Ethereum / USD","",""
"41701548773833","12270.88","-0.48","EURd","SWAP","PROCESSED","2023-10-07 21:21:46","","ETH/USD","Ethereum / USD","",""
"41701548773762","12271.36","-0.48","EURd","SWAP","PROCESSED","2023-10-07 21:21:46","","ETH/USD","Ethereum / USD","",""
"41701547724647","12271.84","-0.48","EURd","SWAP","PROCESSED","2023-10-07 21:21:45","","ETH/USD","Ethereum / USD","",""
"41701532000667","12272.32","-0.33","EURd","SWAP","PROCESSED","2023-10-07 21:21:30","","TSLA","Tesla Inc (Extended Hours)","",""
"41611023121801","12272.65","-0.33","EURd","SWAP","PROCESSED","2023-10-06 21:22:54","","TSLA","Tesla Inc (Extended Hours)","",""
"41611010530165","12272.98","-0.14","EURd","SWAP","PROCESSED","2023-10-06 21:22:42","","AMD","Advanced Micro Devices Inc (Extended Hours)","",""
"41611009481257","12273.12","-0.22","EURd","SWAP","PROCESSED","2023-10-06 21:22:41","","AMD","Advanced Micro Devices Inc (Extended Hours)","",""
"41611009481151","12273.34","-0.06","EURd","SWAP","PROCESSED","2023-10-06 21:22:41","","AMD","Advanced Micro Devices Inc (Extended Hours)","",""
"41610996905011","12273.4","-0.48","EURd","SWAP","PROCESSED","2023-10-06 21:22:29","","ETH/USD","Ethereum / USD","",""
"41610996904777","12273.88","-0.48","EURd","SWAP","PROCESSED","2023-10-06 21:22:29","","ETH/USD","Ethereum / USD","",""
"41610996904683","12274.36","-0.48","EURd","SWAP","PROCESSED","2023-10-06 21:22:29","","ETH/USD","Ethereum / USD","",""
"41610996904630","12274.84","-0.48","EURd","SWAP","PROCESSED","2023-10-06 21:22:29","","ETH/USD","Ethereum / USD","",""
"41610995855477","12275.32","-0.48","EURd","SWAP","PROCESSED","2023-10-06 21:22:28","","ETH/USD","Ethereum / USD","",""
"41610944470921","12275.8","-0.34","EURd","SWAP","PROCESSED","2023-10-06 21:21:39","","NVDA","NVIDIA Corp (Extended Hours)","",""
"41610943422034","12276.14","-0.34","EURd","SWAP","PROCESSED","2023-10-06 21:21:38","","NVDA","NVIDIA Corp (Extended Hours)","",""
"41610849048053","12276.48","-0.23","EURd","SWAP","PROCESSED","2023-10-06 21:20:08","","TSM","Taiwan Semiconductor Manufacturing Co Ltd - ADR (Extended Hours)","",""
"41610849047958","12276.71","-0.23","EURd","SWAP","PROCESSED","2023-10-06 21:20:08","","TSM","Taiwan Semiconductor Manufacturing Co Ltd - ADR (Extended Hours)","",""
"41590073621763","12276.94","2.36","EURd","TRADE","PROCESSED","2023-10-06 15:49:55","00001344-0055-311e-0000-4cb4000f1c01_00001344-0055-311e-0000-0000802429ca","AMD","Advanced Micro Devices Inc (Extended Hours)","",""
"41587463703981","12274.58","12.23","EURd","TRADE","PROCESSED","2023-10-06 15:08:26","000144cd-0055-311e-0000-4cb400123132_000144cd-0055-311e-0000-0000804c0251","TSM","Taiwan Semiconductor Manufacturing Co Ltd - ADR (Extended Hours)","",""
"41587458461039","12262.35","9.53","EURd","TRADE","PROCESSED","2023-10-06 15:08:21","000940dd-0055-311e-0000-4cb40009a281_000940dd-0055-311e-0000-000081a9f58c","BTC/USD","Bitcoin / USD","",""
"41520513182897","12252.82","-0.13","EURd","SWAP","PROCESSED","2023-10-05 21:24:17","","AMD","Advanced Micro Devices Inc (Extended Hours)","",""
"41520513182768","12252.95","-0.21","EURd","SWAP","PROCESSED","2023-10-05 21:24:17","","AMD","Advanced Micro Devices Inc (Extended Hours)","",""
"41520513182753","12253.16","-0.06","EURd","SWAP","PROCESSED","2023-10-05 21:24:17","","AMD","Advanced Micro Devices Inc (Extended Hours)","",""
"41520367419744","12253.22","-0.34","EURd","SWAP","PROCESSED","2023-10-05 21:21:58","","NVDA","NVIDIA Corp (Extended Hours)","",""
"41520366370856","12253.56","-0.34","EURd","SWAP","PROCESSED","2023-10-05 21:21:57","","NVDA","NVIDIA Corp (Extended Hours)","",""
"41520305559343","12253.9","-0.81","EURd","SWAP","PROCESSED","2023-10-05 21:20:59","","BTC/USD","Bitcoin / USD","",""
"41520268867070","12254.71","-0.47","EURd","SWAP","PROCESSED","2023-10-05 21:20:24","","ETH/USD","Ethereum / USD","",""
"41520268866807","12255.18","-0.47","EURd","SWAP","PROCESSED","2023-10-05 21:20:24","","ETH/USD","Ethereum / USD","",""
"41520267818076","12255.65","-0.47","EURd","SWAP","PROCESSED","2023-10-05 21:20:23","","ETH/USD","Ethereum / USD","",""
"41520267818025","12256.12","-0.47","EURd","SWAP","PROCESSED","2023-10-05 21:20:23","","ETH/USD","Ethereum / USD","",""
"41520267817432","12256.59","-0.47","EURd","SWAP","PROCESSED","2023-10-05 21:20:23","","ETH/USD","Ethereum / USD","",""
"41520245799604","12257.06","-0.22","EURd","SWAP","PROCESSED","2023-10-05 21:20:02","","TSM","Taiwan Semiconductor Manufacturing Co Ltd - ADR (Extended Hours)","",""
"41520245799476","12257.28","-0.22","EURd","SWAP","PROCESSED","2023-10-05 21:20:02","","TSM","Taiwan Semiconductor Manufacturing Co Ltd - ADR (Extended Hours)","",""
"41520245799422","12257.5","-0.22","EURd","SWAP","PROCESSED","2023-10-05 21:20:02","","TSM","Taiwan Semiconductor Manufacturing Co Ltd - ADR (Extended Hours)","",""
"41429971793224","12257.72","-0.13","EURd","SWAP","PROCESSED","2023-10-04 21:25:10","","AMD","Advanced Micro Devices Inc (Extended Hours)","",""
"41429971793215","12257.85","-0.21","EURd","SWAP","PROCESSED","2023-10-04 21:25:10","","AMD","Advanced Micro Devices Inc (Extended Hours)","",""
"41429971793202","12258.06","-0.06","EURd","SWAP","PROCESSED","2023-10-04 21:25:10","","AMD","Advanced Micro Devices Inc (Extended Hours)","",""
"41429849098180","12258.12","-0.33","EURd","SWAP","PROCESSED","2023-10-04 21:23:13","","NVDA","NVIDIA Corp (Extended Hours)","",""
"41429848049150","12258.45","-0.33","EURd","SWAP","PROCESSED","2023-10-04 21:23:12","","NVDA","NVIDIA Corp (Extended Hours)","",""
"41429838622295","12258.78","-0.82","EURd","SWAP","PROCESSED","2023-10-04 21:23:03","","BTC/USD","Bitcoin / USD","",""
"41429684479403","12259.6","-0.49","EURd","SWAP","PROCESSED","2023-10-04 21:20:36","","ETH/USD","Ethereum / USD","",""
"41429683430126","12260.09","-0.49","EURd","SWAP","PROCESSED","2023-10-04 21:20:35","","ETH/USD","Ethereum / USD","",""
"41429683430038","12260.58","-0.49","EURd","SWAP","PROCESSED","2023-10-04 21:20:35","","ETH/USD","Ethereum / USD","",""
"41429683429959","12261.07","-0.49","EURd","SWAP","PROCESSED","2023-10-04 21:20:35","","ETH/USD","Ethereum / USD","",""
"41429683429723","12261.56","-0.49","EURd","SWAP","PROCESSED","2023-10-04 21:20:35","","ETH/USD","Ethereum / USD","",""
"41429665609400","12262.05","-0.22","EURd","SWAP","PROCESSED","2023-10-04 21:20:18","","TSM","Taiwan Semiconductor Manufacturing Co Ltd - ADR (Extended Hours)","",""
"41429665609352","12262.27","-0.22","EURd","SWAP","PROCESSED","2023-10-04 21:20:18","","TSM","Taiwan Semiconductor Manufacturing Co Ltd - ADR (Extended Hours)","",""
"41429665609264","12262.49","-0.22","EURd","SWAP","PROCESSED","2023-10-04 21:20:18","","TSM","Taiwan Semiconductor Manufacturing Co Ltd - ADR (Extended Hours)","",""
"41408868153010","12262.71","0.57","EURd","TRADE","PROCESSED","2023-10-04 15:49:44","00001344-0055-311e-0000-4cb2000db3c2_00001344-0055-311e-0000-0000802424cb","AMD","Advanced Micro Devices Inc (Extended Hours)","",""
"41339417809020","12262.14","-0.22","EURd","SWAP","PROCESSED","2023-10-03 21:25:51","","TSM","Taiwan Semiconductor Manufacturing Co Ltd - ADR (Extended Hours)","",""
"41339417809018","12262.36","-0.22","EURd","SWAP","PROCESSED","2023-10-03 21:25:51","","TSM","Taiwan Semiconductor Manufacturing Co Ltd - ADR (Extended Hours)","",""
"41339417809011","12262.58","-0.22","EURd","SWAP","PROCESSED","2023-10-03 21:25:51","","TSM","Taiwan Semiconductor Manufacturing Co Ltd - ADR (Extended Hours)","",""
"41339385300544","12262.8","-0.13","EURd","SWAP","PROCESSED","2023-10-03 21:25:20","","AMD","Advanced Micro Devices Inc (Extended Hours)","",""
"41339385300517","12262.93","-0.13","EURd","SWAP","PROCESSED","2023-10-03 21:25:20","","AMD","Advanced Micro Devices Inc (Extended Hours)","",""
"41339385300491","12263.06","-0.2","EURd","SWAP","PROCESSED","2023-10-03 21:25:20","","AMD","Advanced Micro Devices Inc (Extended Hours)","",""
"41339384251905","12263.26","-0.06","EURd","SWAP","PROCESSED","2023-10-03 21:25:19","","AMD","Advanced Micro Devices Inc (Extended Hours)","",""
"41339382154272","12263.32","-0.33","EURd","SWAP","PROCESSED","2023-10-03 21:25:17","","NVDA","NVIDIA Corp (Extended Hours)","",""
"41339381105613","12263.65","-0.33","EURd","SWAP","PROCESSED","2023-10-03 21:25:16","","NVDA","NVIDIA Corp (Extended Hours)","",""
"41339309805686","12263.98","-0.81","EURd","SWAP","PROCESSED","2023-10-03 21:24:08","","BTC/USD","Bitcoin / USD","",""
"41339192375818","12264.79","-0.5","EURd","SWAP","PROCESSED","2023-10-03 21:22:16","","ETH/USD","Ethereum / USD","",""
"41339192375645","12265.29","-0.5","EURd","SWAP","PROCESSED","2023-10-03 21:22:16","","ETH/USD","Ethereum / USD","",""
"41339192375558","12265.79","-0.5","EURd","SWAP","PROCESSED","2023-10-03 21:22:16","","ETH/USD","Ethereum / USD","",""
"41339192375326","12266.29","-0.5","EURd","SWAP","PROCESSED","2023-10-03 21:22:16","","ETH/USD","Ethereum / USD","",""
"41248558697356","12266.79","-0.34","EURd","SWAP","PROCESSED","2023-10-02 21:21:41","","NVDA","NVIDIA Corp (Extended Hours)","",""
"41248557648378","12267.13","-0.34","EURd","SWAP","PROCESSED","2023-10-02 21:21:40","","NVDA","NVIDIA Corp (Extended Hours)","",""
"41248498936549","12267.47","-0.22","EURd","SWAP","PROCESSED","2023-10-02 21:20:44","","TSM","Taiwan Semiconductor Manufacturing Co Ltd - ADR (Extended Hours)","",""
"41248498936477","12267.69","-0.22","EURd","SWAP","PROCESSED","2023-10-02 21:20:44","","TSM","Taiwan Semiconductor Manufacturing Co Ltd - ADR (Extended Hours)","",""
"41248497887839","12267.91","-0.22","EURd","SWAP","PROCESSED","2023-10-02 21:20:43","","TSM","Taiwan Semiconductor Manufacturing Co Ltd - ADR (Extended Hours)","",""
"41248494739657","12268.13","-0.5","EURd","SWAP","PROCESSED","2023-10-02 21:20:40","","ETH/USD","Ethereum / USD","",""
"41248494739615","12268.63","-0.5","EURd","SWAP","PROCESSED","2023-10-02 21:20:40","","ETH/USD","Ethereum / USD","",""
"41248494739333","12269.13","-0.5","EURd","SWAP","PROCESSED","2023-10-02 21:20:40","","ETH/USD","Ethereum / USD","",""
"41248454900174","12269.63","-0.13","EURd","SWAP","PROCESSED","2023-10-02 21:20:02","","AMD","Advanced Micro Devices Inc (Extended Hours)","",""
"41248453851326","12269.76","-0.13","EURd","SWAP","PROCESSED","2023-10-02 21:20:01","","AMD","Advanced Micro Devices Inc (Extended Hours)","",""
"41248453851221","12269.89","-0.21","EURd","SWAP","PROCESSED","2023-10-02 21:20:01","","AMD","Advanced Micro Devices Inc (Extended Hours)","",""
"41248453851144","12270.1","-0.06","EURd","SWAP","PROCESSED","2023-10-02 21:20:01","","AMD","Advanced Micro Devices Inc (Extended Hours)","",""
"41236477007413","12270.16","44.18","EURd","TRADE","PROCESSED","2023-10-02 18:09:39","000940dd-0055-311e-0000-4cb0000d406b_000940dd-0055-311e-0000-000081a95e83","BTC/USD","Bitcoin / USD","",""
"41236477007412","12225.98","-4.73","EURd","TRADE","PROCESSED","2023-10-02 18:09:39","000940dd-0055-311e-0000-4cb0000d406a_000940dd-0055-311e-0000-000081a9c5af","BTC/USD","Bitcoin / USD","",""
"41158114832709","12230.71","-0.33","EURd","SWAP","PROCESSED","2023-10-01 21:24:07","","NVDA","NVIDIA Corp (Extended Hours)","",""
"41158114832442","12231.04","-0.33","EURd","SWAP","PROCESSED","2023-10-01 21:24:07","","NVDA","NVIDIA Corp (Extended Hours)","",""
"41158103292518","12231.37","-0.79","EURd","SWAP","PROCESSED","2023-10-01 21:23:56","","BTC/USD","Bitcoin / USD","",""
"41158016267667","12232.16","-0.49","EURd","SWAP","PROCESSED","2023-10-01 21:22:33","","ETH/USD","Ethereum / USD","",""
"41157999481705","12232.65","-0.22","EURd","SWAP","PROCESSED","2023-10-01 21:22:17","","TSM","Taiwan Semiconductor Manufacturing Co Ltd - ADR (Extended Hours)","",""
"41157999481655","12232.87","-0.22","EURd","SWAP","PROCESSED","2023-10-01 21:22:17","","TSM","Taiwan Semiconductor Manufacturing Co Ltd - ADR (Extended Hours)","",""
"41157878899751","12233.09","-0.13","EURd","SWAP","PROCESSED","2023-10-01 21:20:22","","AMD","Advanced Micro Devices Inc (Extended Hours)","",""
"41157877851088","12233.22","-0.21","EURd","SWAP","PROCESSED","2023-10-01 21:20:21","","AMD","Advanced Micro Devices Inc (Extended Hours)","",""
"41157877851027","12233.43","-0.06","EURd","SWAP","PROCESSED","2023-10-01 21:20:21","","AMD","Advanced Micro Devices Inc (Extended Hours)","",""
"41067425592362","12233.49","-0.49","EURd","SWAP","PROCESSED","2023-09-30 21:22:39","","ETH/USD","Ethereum / USD","",""
"41067393086210","12233.98","-0.22","EURd","SWAP","PROCESSED","2023-09-30 21:22:08","","TSM","Taiwan Semiconductor Manufacturing Co Ltd - ADR (Extended Hours)","",""
"41067393086155","12234.2","-0.22","EURd","SWAP","PROCESSED","2023-09-30 21:22:08","","TSM","Taiwan Semiconductor Manufacturing Co Ltd - ADR (Extended Hours)","",""
"41067373153255","12234.42","-0.79","EURd","SWAP","PROCESSED","2023-09-30 21:21:49","","BTC/USD","Bitcoin / USD","",""
"41067343793279","12235.21","-0.13","EURd","SWAP","PROCESSED","2023-09-30 21:21:21","","AMD","Advanced Micro Devices Inc (Extended Hours)","",""
"41067342744566","12235.34","-0.21","EURd","SWAP","PROCESSED","2023-09-30 21:21:20","","AMD","Advanced Micro Devices Inc (Extended Hours)","",""
"41067342744506","12235.55","-0.06","EURd","SWAP","PROCESSED","2023-09-30 21:21:20","","AMD","Advanced Micro Devices Inc (Extended Hours)","",""
"41067287174263","12235.61","-0.33","EURd","SWAP","PROCESSED","2023-09-30 21:20:27","","NVDA","NVIDIA Corp (Extended Hours)","",""
"41067287173928","12235.94","-0.33","EURd","SWAP","PROCESSED","2023-09-30 21:20:27","","NVDA","NVIDIA Corp (Extended Hours)","",""
"41055143612233","12236.27","5.9","EURd","TRADE","PROCESSED","2023-09-30 18:07:26","000940dd-0055-311e-0000-4cae00020528_000940dd-0055-311e-0000-000081a9680e","BTC/USD","Bitcoin / USD","",""
"40976991148465","12230.37","-0.22","EURd","SWAP","PROCESSED","2023-09-29 21:25:14","","TSM","Taiwan Semiconductor Manufacturing Co Ltd - ADR (Extended Hours)","",""
"40976991148459","12230.59","-0.22","EURd","SWAP","PROCESSED","2023-09-29 21:25:14","","TSM","Taiwan Semiconductor Manufacturing Co Ltd - ADR (Extended Hours)","",""
"40976990099808","12230.81","-0.49","EURd","SWAP","PROCESSED","2023-09-29 21:25:13","","ETH/USD","Ethereum / USD","",""
"40976972271133","12231.3","-0.78","EURd","SWAP","PROCESSED","2023-09-29 21:24:56","","BTC/USD","Bitcoin / USD","",""
"40976971222436","12232.08","-0.78","EURd","SWAP","PROCESSED","2023-09-29 21:24:55","","BTC/USD","Bitcoin / USD","",""
"40976872668821","12232.86","-0.33","EURd","SWAP","PROCESSED","2023-09-29 21:23:21","","NVDA","NVIDIA Corp (Extended Hours)","",""
"40976871619808","12233.19","-0.33","EURd","SWAP","PROCESSED","2023-09-29 21:23:20","","NVDA","NVIDIA Corp (Extended Hours)","",""
"40976703836150","12233.52","-0.13","EURd","SWAP","PROCESSED","2023-09-29 21:20:40","","AMD","Advanced Micro Devices Inc (Extended Hours)","",""
"40976703836069","12233.65","-0.21","EURd","SWAP","PROCESSED","2023-09-29 21:20:40","","AMD","Advanced Micro Devices Inc (Extended Hours)","",""
"40976703836002","12233.86","-0.06","EURd","SWAP","PROCESSED","2023-09-29 21:20:40","","AMD","Advanced Micro Devices Inc (Extended Hours)","",""
"40966652187758","12233.92","2.84","EURd","TRADE","PROCESSED","2023-09-29 18:40:54","00016258-0055-311e-0000-4cad0019ee9c_00016258-0055-311e-0000-0000805056b2","VIX","Volatility Index","",""
"40945088231365","12231.08","4.81","EURd","TRADE","PROCESSED","2023-09-29 12:58:09","000144cd-0055-311e-0000-4cad0008e7c4_000144cd-0055-311e-0000-0000804c022f","TSM","Taiwan Semiconductor Manufacturing Co Ltd - ADR (Extended Hours)","",""
"40945046288070","12226.27","-7.12","EURd","TRADE","PROCESSED","2023-09-29 12:57:29","00001344-0055-311e-0000-4cad00015d27_00001344-0055-311e-0000-0000802410cf","AMD","Advanced Micro Devices Inc (Extended Hours)","",""
"40945039996584","12233.39","4.86","EURd","TRADE","PROCESSED","2023-09-29 12:57:23","00001344-0055-311e-0000-4cad00015d12_00001344-0055-311e-0000-0000802421c9","AMD","Advanced Micro Devices Inc (Extended Hours)","",""
"40935013501557","12228.53","12.15","EURd","TRADE","PROCESSED","2023-09-29 10:18:01","00396101-0055-311e-0000-4cad0000e03a_00396101-0055-311e-0000-000080267003","NVDA","NVIDIA Corp (Extended Hours)","",""
"40934616089576","12216.38","12.63","EURd","TRADE","PROCESSED","2023-09-29 10:11:42","00081081-0055-311e-0000-4cad0000dbe6_00081081-0055-311e-0000-000080240aab","BABA","Alibaba Group Holding Limited (Extended Hours)","",""
"40934615040985","12203.75","14.7","EURd","TRADE","PROCESSED","2023-09-29 10:11:41","00513301-0055-311e-0000-4cad00048dda_00513301-0055-311e-0000-00008087ca89","TSLA","Tesla Inc (Extended Hours)","",""
"40886384745223","12189.05","-0.22","EURd","SWAP","PROCESSED","2023-09-28 21:25:05","","TSM","Taiwan Semiconductor Manufacturing Co Ltd - ADR (Extended Hours)","",""
"40886384745197","12189.27","-0.22","EURd","SWAP","PROCESSED","2023-09-28 21:25:05","","TSM","Taiwan Semiconductor Manufacturing Co Ltd - ADR (Extended Hours)","",""
"40886238991909","12189.49","-0.32","EURd","SWAP","PROCESSED","2023-09-28 21:22:46","","NVDA","NVIDIA Corp (Extended Hours)","",""
"40886238991424","12189.81","-0.32","EURd","SWAP","PROCESSED","2023-09-28 21:22:46","","NVDA","NVIDIA Corp (Extended Hours)","",""
"40886076463617","12190.13","-0.13","EURd","SWAP","PROCESSED","2023-09-28 21:20:11","","AMD","Advanced Micro Devices Inc (Extended Hours)","",""
"40886075414519","12190.26","-0.13","EURd","SWAP","PROCESSED","2023-09-28 21:20:10","","AMD","Advanced Micro Devices Inc (Extended Hours)","",""
"40886075414458","12190.39","-0.13","EURd","SWAP","PROCESSED","2023-09-28 21:20:10","","AMD","Advanced Micro Devices Inc (Extended Hours)","",""
"40886075414195","12190.52","-0.21","EURd","SWAP","PROCESSED","2023-09-28 21:20:10","","AMD","Advanced Micro Devices Inc (Extended Hours)","",""
"40886074365570","12190.73","-0.06","EURd","SWAP","PROCESSED","2023-09-28 21:20:09","","AMD","Advanced Micro Devices Inc (Extended Hours)","",""
"40866005673275","12190.79","6.41","EURd","TRADE","PROCESSED","2023-09-28 16:01:10","0015421d-0055-311e-0000-4cac00046ab1_0015421d-0055-311e-0000-000080e5247e","ETH/USD","Ethereum / USD","",""
"40866005673274","12184.38","1.5","EURd","TRADE","PROCESSED","2023-09-28 16:01:10","0015421d-0055-311e-0000-4cac00046ab0_0015421d-0055-311e-0000-000080e507d2","ETH/USD","Ethereum / USD","",""
"40866005673273","12182.88","11.4","EURd","TRADE","PROCESSED","2023-09-28 16:01:10","0015421d-0055-311e-0000-4cac00046aaf_0015421d-0055-311e-0000-000080e5a14f","ETH/USD","Ethereum / USD","",""
"40864844904223","12171.48","20.08","EURd","TRADE","PROCESSED","2023-09-28 15:42:43","00396101-0055-311e-0000-4cac000c760b_00396101-0055-311e-0000-0000802659b1","NVDA","NVIDIA Corp (Extended Hours)","",""
"40795301241566","12151.4","-0.48","EURd","SWAP","PROCESSED","2023-09-27 21:17:21","","ETH/USD","Ethereum / USD","",""
"40795298093967","12151.88","-0.48","EURd","SWAP","PROCESSED","2023-09-27 21:17:18","","ETH/USD","Ethereum / USD","",""
"40795298093604","12152.36","-0.48","EURd","SWAP","PROCESSED","2023-09-27 21:17:18","","ETH/USD","Ethereum / USD","",""
"40795045385652","12152.84","-0.22","EURd","SWAP","PROCESSED","2023-09-27 21:13:17","","TSM","Taiwan Semiconductor Manufacturing Co Ltd - ADR (Extended Hours)","",""
"40795045385473","12153.06","-0.22","EURd","SWAP","PROCESSED","2023-09-27 21:13:17","","TSM","Taiwan Semiconductor Manufacturing Co Ltd - ADR (Extended Hours)","",""
"40794702499425","12153.28","-0.32","EURd","SWAP","PROCESSED","2023-09-27 21:07:50","","NVDA","NVIDIA Corp (Extended Hours)","",""
"40794699352156","12153.6","-0.32","EURd","SWAP","PROCESSED","2023-09-27 21:07:47","","NVDA","NVIDIA Corp (Extended Hours)","",""
"40794697253718","12153.92","-0.32","EURd","SWAP","PROCESSED","2023-09-27 21:07:45","","NVDA","NVIDIA Corp (Extended Hours)","",""
"40794457136860","12154.24","-0.12","EURd","SWAP","PROCESSED","2023-09-27 21:03:56","","AMD","Advanced Micro Devices Inc (Extended Hours)","",""
"40794457136756","12154.36","-0.12","EURd","SWAP","PROCESSED","2023-09-27 21:03:56","","AMD","Advanced Micro Devices Inc (Extended Hours)","",""
"40794456087880","12154.48","-0.2","EURd","SWAP","PROCESSED","2023-09-27 21:03:55","","AMD","Advanced Micro Devices Inc (Extended Hours)","",""
"40794456087819","12154.68","-0.06","EURd","SWAP","PROCESSED","2023-09-27 21:03:55","","AMD","Advanced Micro Devices Inc (Extended Hours)","",""
"40704954888588","12154.74","-0.46","EURd","SWAP","PROCESSED","2023-09-26 21:21:20","","ETH/USD","Ethereum / USD","",""
"40704951741579","12155.2","-0.46","EURd","SWAP","PROCESSED","2023-09-26 21:21:17","","ETH/USD","Ethereum / USD","",""
"40704950692782","12155.66","-0.46","EURd","SWAP","PROCESSED","2023-09-26 21:21:16","","ETH/USD","Ethereum / USD","",""
"40704735734979","12156.12","-0.22","EURd","SWAP","PROCESSED","2023-09-26 21:17:51","","TSM","Taiwan Semiconductor Manufacturing Co Ltd - ADR (Extended Hours)","",""
"40704734686283","12156.34","-0.22","EURd","SWAP","PROCESSED","2023-09-26 21:17:50","","TSM","Taiwan Semiconductor Manufacturing Co Ltd - ADR (Extended Hours)","",""
"40704189421897","12156.56","-0.31","EURd","SWAP","PROCESSED","2023-09-26 21:09:10","","NVDA","NVIDIA Corp (Extended Hours)","",""
"40704186274657","12156.87","-0.31","EURd","SWAP","PROCESSED","2023-09-26 21:09:07","","NVDA","NVIDIA Corp (Extended Hours)","",""
"40704184176217","12157.18","-0.31","EURd","SWAP","PROCESSED","2023-09-26 21:09:05","","NVDA","NVIDIA Corp (Extended Hours)","",""
"40704121272341","12157.49","-0.12","EURd","SWAP","PROCESSED","2023-09-26 21:08:05","","AMD","Advanced Micro Devices Inc (Extended Hours)","",""
"40704120223680","12157.61","-0.12","EURd","SWAP","PROCESSED","2023-09-26 21:08:04","","AMD","Advanced Micro Devices Inc (Extended Hours)","",""
"40704120223377","12157.73","-0.2","EURd","SWAP","PROCESSED","2023-09-26 21:08:04","","AMD","Advanced Micro Devices Inc (Extended Hours)","",""
"40704120223317","12157.93","-0.06","EURd","SWAP","PROCESSED","2023-09-26 21:08:04","","AMD","Advanced Micro Devices Inc (Extended Hours)","",""
"40614317027351","12157.99","-0.46","EURd","SWAP","PROCESSED","2023-09-25 21:20:41","","ETH/USD","Ethereum / USD","",""
"40614313879890","12158.45","-0.46","EURd","SWAP","PROCESSED","2023-09-25 21:20:38","","ETH/USD","Ethereum / USD","",""
"40614312831021","12158.91","-0.46","EURd","SWAP","PROCESSED","2023-09-25 21:20:37","","ETH/USD","Ethereum / USD","",""
"40614010838610","12159.37","-0.22","EURd","SWAP","PROCESSED","2023-09-25 21:15:49","","TSM","Taiwan Semiconductor Manufacturing Co Ltd - ADR (Extended Hours)","",""
"40614010838448","12159.59","-0.22","EURd","SWAP","PROCESSED","2023-09-25 21:15:49","","TSM","Taiwan Semiconductor Manufacturing Co Ltd - ADR (Extended Hours)","",""
"40613852510727","12159.81","-0.12","EURd","SWAP","PROCESSED","2023-09-25 21:13:18","","AMD","Advanced Micro Devices Inc (Extended Hours)","",""
"40613851461948","12159.93","-0.12","EURd","SWAP","PROCESSED","2023-09-25 21:13:17","","AMD","Advanced Micro Devices Inc (Extended Hours)","",""
"40613851461615","12160.05","-0.2","EURd","SWAP","PROCESSED","2023-09-25 21:13:17","","AMD","Advanced Micro Devices Inc (Extended Hours)","",""
"40613851461551","12160.25","-0.06","EURd","SWAP","PROCESSED","2023-09-25 21:13:17","","AMD","Advanced Micro Devices Inc (Extended Hours)","",""
"40613245377270","12160.31","-0.32","EURd","SWAP","PROCESSED","2023-09-25 21:03:39","","NVDA","NVIDIA Corp (Extended Hours)","",""
"40613242229554","12160.63","-0.32","EURd","SWAP","PROCESSED","2023-09-25 21:03:36","","NVDA","NVIDIA Corp (Extended Hours)","",""
"40613240130803","12160.95","-0.32","EURd","SWAP","PROCESSED","2023-09-25 21:03:34","","NVDA","NVIDIA Corp (Extended Hours)","",""
"40595411194539","12161.27","0.95","EURd","TRADE","PROCESSED","2023-09-25 16:20:11","0015421d-0055-311e-0000-4ca90004cbd0_0015421d-0055-311e-0000-000080e5a7e3","ETH/USD","Ethereum / USD","",""
"40595404903073","12160.32","6","EURd","TRADE","PROCESSED","2023-09-25 16:20:05","000940dd-0055-311e-0000-4ca9000a7aa5_000940dd-0055-311e-0000-000081a8f685","BTC/USD","Bitcoin / USD","",""
"40588042846322","12154.32","28.02","EURd","TRADE","PROCESSED","2023-09-25 14:23:04","00396101-0055-311e-0000-4ca9000717bd_00396101-0055-311e-0000-0000802655ba","NVDA","NVIDIA Corp (Extended Hours)","",""
"40523648746255","12126.3","-0.47","EURd","SWAP","PROCESSED","2023-09-24 21:19:33","","ETH/USD","Ethereum / USD","",""
"40523648746135","12126.77","-0.47","EURd","SWAP","PROCESSED","2023-09-24 21:19:33","","ETH/USD","Ethereum / USD","",""
"40523644566262","12127.24","-0.47","EURd","SWAP","PROCESSED","2023-09-24 21:19:29","","ETH/USD","Ethereum / USD","",""
"40523643517360","12127.71","-0.47","EURd","SWAP","PROCESSED","2023-09-24 21:19:28","","ETH/USD","Ethereum / USD","",""
"40523337319766","12128.18","-0.22","EURd","SWAP","PROCESSED","2023-09-24 21:14:36","","TSM","Taiwan Semiconductor Manufacturing Co Ltd - ADR (Extended Hours)","",""
"40523337319615","12128.4","-0.22","EURd","SWAP","PROCESSED","2023-09-24 21:14:36","","TSM","Taiwan Semiconductor Manufacturing Co Ltd - ADR (Extended Hours)","",""
"40523181089300","12128.62","-0.12","EURd","SWAP","PROCESSED","2023-09-24 21:12:07","","AMD","Advanced Micro Devices Inc (Extended Hours)","",""
"40523180040563","12128.74","-0.12","EURd","SWAP","PROCESSED","2023-09-24 21:12:06","","AMD","Advanced Micro Devices Inc (Extended Hours)","",""
"40523180040263","12128.86","-0.2","EURd","SWAP","PROCESSED","2023-09-24 21:12:06","","AMD","Advanced Micro Devices Inc (Extended Hours)","",""
"40523180040195","12129.06","-0.06","EURd","SWAP","PROCESSED","2023-09-24 21:12:06","","AMD","Advanced Micro Devices Inc (Extended Hours)","",""
"40522649452789","12129.12","-0.31","EURd","SWAP","PROCESSED","2023-09-24 21:03:40","","NVDA","NVIDIA Corp (Extended Hours)","",""
"40522647370307","12129.43","-0.31","EURd","SWAP","PROCESSED","2023-09-24 21:03:38","","NVDA","NVIDIA Corp (Extended Hours)","",""
"40432794890634","12129.74","-0.22","EURd","SWAP","PROCESSED","2023-09-23 21:15:28","","TSM","Taiwan Semiconductor Manufacturing Co Ltd - ADR (Extended Hours)","",""
"40432794890445","12129.96","-0.22","EURd","SWAP","PROCESSED","2023-09-23 21:15:28","","TSM","Taiwan Semiconductor Manufacturing Co Ltd - ADR (Extended Hours)","",""
"40432684788214","12130.18","-0.31","EURd","SWAP","PROCESSED","2023-09-23 21:13:43","","NVDA","NVIDIA Corp (Extended Hours)","",""
"40432682689398","12130.49","-0.31","EURd","SWAP","PROCESSED","2023-09-23 21:13:41","","NVDA","NVIDIA Corp (Extended Hours)","",""
"40432614523007","12130.8","-0.12","EURd","SWAP","PROCESSED","2023-09-23 21:12:36","","AMD","Advanced Micro Devices Inc (Extended Hours)","",""
"40432614522882","12130.92","-0.12","EURd","SWAP","PROCESSED","2023-09-23 21:12:36","","AMD","Advanced Micro Devices Inc (Extended Hours)","",""
"40432613490378","12131.04","-0.2","EURd","SWAP","PROCESSED","2023-09-23 21:12:35","","AMD","Advanced Micro Devices Inc (Extended Hours)","",""
"40432613490310","12131.24","-0.06","EURd","SWAP","PROCESSED","2023-09-23 21:12:35","","AMD","Advanced Micro Devices Inc (Extended Hours)","",""
"40432183558648","12131.3","-0.47","EURd","SWAP","PROCESSED","2023-09-23 21:05:45","","ETH/USD","Ethereum / USD","",""
"40432182509959","12131.77","-0.47","EURd","SWAP","PROCESSED","2023-09-23 21:05:44","","ETH/USD","Ethereum / USD","",""
"40432179378132","12132.24","-0.47","EURd","SWAP","PROCESSED","2023-09-23 21:05:41","","ETH/USD","Ethereum / USD","",""
"40432178329158","12132.71","-0.47","EURd","SWAP","PROCESSED","2023-09-23 21:05:40","","ETH/USD","Ethereum / USD","",""
"40342128707816","12133.18","-0.22","EURd","SWAP","PROCESSED","2023-09-22 21:14:22","","TSM","Taiwan Semiconductor Manufacturing Co Ltd - ADR (Extended Hours)","",""
"40342128707686","12133.4","-0.22","EURd","SWAP","PROCESSED","2023-09-22 21:14:22","","TSM","Taiwan Semiconductor Manufacturing Co Ltd - ADR (Extended Hours)","",""
"40341939976390","12133.62","-0.12","EURd","SWAP","PROCESSED","2023-09-22 21:11:22","","AMD","Advanced Micro Devices Inc (Extended Hours)","",""
"40341939976234","12133.74","-0.12","EURd","SWAP","PROCESSED","2023-09-22 21:11:22","","AMD","Advanced Micro Devices Inc (Extended Hours)","",""
"40341938927293","12133.86","-0.2","EURd","SWAP","PROCESSED","2023-09-22 21:11:21","","AMD","Advanced Micro Devices Inc (Extended Hours)","",""
"40341938927245","12134.06","-0.06","EURd","SWAP","PROCESSED","2023-09-22 21:11:21","","AMD","Advanced Micro Devices Inc (Extended Hours)","",""
"40341721865966","12134.12","-0.47","EURd","SWAP","PROCESSED","2023-09-22 21:07:54","","ETH/USD","Ethereum / USD","",""
"40341721865835","12134.59","-0.47","EURd","SWAP","PROCESSED","2023-09-22 21:07:54","","ETH/USD","Ethereum / USD","",""
"40341716620041","12135.06","-0.47","EURd","SWAP","PROCESSED","2023-09-22 21:07:49","","ETH/USD","Ethereum / USD","",""
"40341716619664","12135.53","-0.47","EURd","SWAP","PROCESSED","2023-09-22 21:07:49","","ETH/USD","Ethereum / USD","",""
"40341358013457","12136","-0.31","EURd","SWAP","PROCESSED","2023-09-22 21:02:07","","NVDA","NVIDIA Corp (Extended Hours)","",""
"40341351718420","12136.31","-0.31","EURd","SWAP","PROCESSED","2023-09-22 21:02:01","","NVDA","NVIDIA Corp (Extended Hours)","",""
"40251954321354","12136.62","-0.31","EURd","SWAP","PROCESSED","2023-09-21 21:21:05","","NVDA","NVIDIA Corp (Extended Hours)","",""
"40251952223246","12136.93","-0.31","EURd","SWAP","PROCESSED","2023-09-21 21:21:03","","NVDA","NVIDIA Corp (Extended Hours)","",""
"40251721546890","12137.24","-0.22","EURd","SWAP","PROCESSED","2023-09-21 21:17:23","","TSM","Taiwan Semiconductor Manufacturing Co Ltd - ADR (Extended Hours)","",""
"40251721546738","12137.46","-0.22","EURd","SWAP","PROCESSED","2023-09-21 21:17:23","","TSM","Taiwan Semiconductor Manufacturing Co Ltd - ADR (Extended Hours)","",""
"40251368166676","12137.68","-0.12","EURd","SWAP","PROCESSED","2023-09-21 21:11:46","","AMD","Advanced Micro Devices Inc (Extended Hours)","",""
"40251368166569","12137.8","-0.12","EURd","SWAP","PROCESSED","2023-09-21 21:11:46","","AMD","Advanced Micro Devices Inc (Extended Hours)","",""
"40251367117594","12137.92","-0.2","EURd","SWAP","PROCESSED","2023-09-21 21:11:45","","AMD","Advanced Micro Devices Inc (Extended Hours)","",""
"40251367117540","12138.12","-0.06","EURd","SWAP","PROCESSED","2023-09-21 21:11:45","","AMD","Advanced Micro Devices Inc (Extended Hours)","",""
"40251156360776","12138.18","-0.46","EURd","SWAP","PROCESSED","2023-09-21 21:08:24","","ETH/USD","Ethereum / USD","",""
"40251156360649","12138.64","-0.46","EURd","SWAP","PROCESSED","2023-09-21 21:08:24","","ETH/USD","Ethereum / USD","",""
"40251151114920","12139.1","-0.46","EURd","SWAP","PROCESSED","2023-09-21 21:08:19","","ETH/USD","Ethereum / USD","",""
"40251151114507","12139.56","-0.46","EURd","SWAP","PROCESSED","2023-09-21 21:08:19","","ETH/USD","Ethereum / USD","",""
"40161270326320","12140.02","-0.32","EURd","SWAP","PROCESSED","2023-09-20 21:19:42","","NVDA","NVIDIA Corp (Extended Hours)","",""
"40161267179008","12140.34","-0.32","EURd","SWAP","PROCESSED","2023-09-20 21:19:39","","NVDA","NVIDIA Corp (Extended Hours)","",""
"40161033343949","12140.66","-0.22","EURd","SWAP","PROCESSED","2023-09-20 21:15:56","","TSM","Taiwan Semiconductor Manufacturing Co Ltd - ADR (Extended Hours)","",""
"40161032294811","12140.88","-0.22","EURd","SWAP","PROCESSED","2023-09-20 21:15:55","","TSM","Taiwan Semiconductor Manufacturing Co Ltd - ADR (Extended Hours)","",""
"40160752321178","12141.1","-0.48","EURd","SWAP","PROCESSED","2023-09-20 21:11:28","","ETH/USD","Ethereum / USD","",""
"40160747091391","12141.58","-0.48","EURd","SWAP","PROCESSED","2023-09-20 21:11:23","","ETH/USD","Ethereum / USD","",""
"40160747091012","12142.06","-0.48","EURd","SWAP","PROCESSED","2023-09-20 21:11:23","","ETH/USD","Ethereum / USD","",""
"40160657958155","12142.54","-0.13","EURd","SWAP","PROCESSED","2023-09-20 21:09:58","","AMD","Advanced Micro Devices Inc (Extended Hours)","",""
"40160657958029","12142.67","-0.13","EURd","SWAP","PROCESSED","2023-09-20 21:09:58","","AMD","Advanced Micro Devices Inc (Extended Hours)","",""
"40160656909050","12142.8","-0.2","EURd","SWAP","PROCESSED","2023-09-20 21:09:57","","AMD","Advanced Micro Devices Inc (Extended Hours)","",""
"40160656909017","12143","-0.06","EURd","SWAP","PROCESSED","2023-09-20 21:09:57","","AMD","Advanced Micro Devices Inc (Extended Hours)","",""
"40141611629589","12143.06","1.71","EURd","TRADE","PROCESSED","2023-09-20 16:07:14","00396101-0055-311e-0000-4ca40009d926_00396101-0055-311e-0000-0000802641da","NVDA","NVIDIA Corp (Extended Hours)","",""
"40070580039302","12141.35","-0.22","EURd","SWAP","PROCESSED","2023-09-19 21:18:13","","TSM","Taiwan Semiconductor Manufacturing Co Ltd - ADR (Extended Hours)","",""
"40070578990600","12141.57","-0.22","EURd","SWAP","PROCESSED","2023-09-19 21:18:12","","TSM","Taiwan Semiconductor Manufacturing Co Ltd - ADR (Extended Hours)","",""
"40070280146435","12141.79","-0.13","EURd","SWAP","PROCESSED","2023-09-19 21:13:27","","AMD","Advanced Micro Devices Inc (Extended Hours)","",""
"40070280146149","12141.92","-0.13","EURd","SWAP","PROCESSED","2023-09-19 21:13:27","","AMD","Advanced Micro Devices Inc (Extended Hours)","",""
"40070279096883","12142.05","-0.21","EURd","SWAP","PROCESSED","2023-09-19 21:13:26","","AMD","Advanced Micro Devices Inc (Extended Hours)","",""
"40070279096822","12142.26","-0.06","EURd","SWAP","PROCESSED","2023-09-19 21:13:26","","AMD","Advanced Micro Devices Inc (Extended Hours)","",""
"40069896361238","12142.32","-0.48","EURd","SWAP","PROCESSED","2023-09-19 21:07:21","","ETH/USD","Ethereum / USD","",""
"40069895312206","12142.8","-0.48","EURd","SWAP","PROCESSED","2023-09-19 21:07:20","","ETH/USD","Ethereum / USD","",""
"40069798851890","12143.28","-0.33","EURd","SWAP","PROCESSED","2023-09-19 21:05:48","","NVDA","NVIDIA Corp (Extended Hours)","",""
"40069794655208","12143.61","-0.33","EURd","SWAP","PROCESSED","2023-09-19 21:05:44","","NVDA","NVIDIA Corp (Extended Hours)","",""
"40064822307538","12143.94","22.22","EURd","TRADE","PROCESSED","2023-09-19 19:46:42","000940dd-0055-311e-0000-4ca3000be619_000940dd-0055-311e-0000-000081a79556","BTC/USD","Bitcoin / USD","",""
"40064822307537","12121.72","13.19","EURd","TRADE","PROCESSED","2023-09-19 19:46:42","000940dd-0055-311e-0000-4ca3000be618_000940dd-0055-311e-0000-000081a61336","BTC/USD","Bitcoin / USD","",""
"40064822307536","12108.53","-7.09","EURd","TRADE","PROCESSED","2023-09-19 19:46:42","000940dd-0055-311e-0000-4ca3000be617_000940dd-0055-311e-0000-000081a577be","BTC/USD","Bitcoin / USD","",""
"39980104705655","12115.62","-0.13","EURd","SWAP","PROCESSED","2023-09-18 21:20:09","","AMD","Advanced Micro Devices Inc (Extended Hours)","",""
"39980104705572","12115.75","-0.13","EURd","SWAP","PROCESSED","2023-09-18 21:20:09","","AMD","Advanced Micro Devices Inc (Extended Hours)","",""
"39980103656719","12115.88","-0.21","EURd","SWAP","PROCESSED","2023-09-18 21:20:08","","AMD","Advanced Micro Devices Inc (Extended Hours)","",""
"39980103656673","12116.09","-0.06","EURd","SWAP","PROCESSED","2023-09-18 21:20:08","","AMD","Advanced Micro Devices Inc (Extended Hours)","",""
"39979980968769","12116.15","-0.78","EURd","SWAP","PROCESSED","2023-09-18 21:18:11","","BTC/USD","Bitcoin / USD","",""
"39979969443897","12116.93","-0.78","EURd","SWAP","PROCESSED","2023-09-18 21:18:00","","BTC/USD","Bitcoin / USD","",""
"39979968395120","12117.71","-0.78","EURd","SWAP","PROCESSED","2023-09-18 21:17:59","","BTC/USD","Bitcoin / USD","",""
"39979760764876","12118.49","-0.22","EURd","SWAP","PROCESSED","2023-09-18 21:14:41","","TSM","Taiwan Semiconductor Manufacturing Co Ltd - ADR (Extended Hours)","",""
"39979760764767","12118.71","-0.22","EURd","SWAP","PROCESSED","2023-09-18 21:14:41","","TSM","Taiwan Semiconductor Manufacturing Co Ltd - ADR (Extended Hours)","",""
"39979062421683","12118.93","-0.48","EURd","SWAP","PROCESSED","2023-09-18 21:03:35","","ETH/USD","Ethereum / USD","",""
"39979061372674","12119.41","-0.48","EURd","SWAP","PROCESSED","2023-09-18 21:03:34","","ETH/USD","Ethereum / USD","",""
"39979001600371","12119.89","-0.33","EURd","SWAP","PROCESSED","2023-09-18 21:02:37","","NVDA","NVIDIA Corp (Extended Hours)","",""
"39978997403704","12120.22","-0.33","EURd","SWAP","PROCESSED","2023-09-18 21:02:33","","NVDA","NVIDIA Corp (Extended Hours)","",""
"39889508779894","12120.55","-0.13","EURd","SWAP","PROCESSED","2023-09-17 21:20:10","","AMD","Advanced Micro Devices Inc (Extended Hours)","",""
"39889508779829","12120.68","-0.13","EURd","SWAP","PROCESSED","2023-09-17 21:20:10","","AMD","Advanced Micro Devices Inc (Extended Hours)","",""
"39889507731023","12120.81","-0.21","EURd","SWAP","PROCESSED","2023-09-17 21:20:09","","AMD","Advanced Micro Devices Inc (Extended Hours)","",""
"39889507730978","12121.02","-0.06","EURd","SWAP","PROCESSED","2023-09-17 21:20:09","","AMD","Advanced Micro Devices Inc (Extended Hours)","",""
"39889329472946","12121.08","-0.77","EURd","SWAP","PROCESSED","2023-09-17 21:17:19","","BTC/USD","Bitcoin / USD","",""
"39889310603915","12121.85","-0.77","EURd","SWAP","PROCESSED","2023-09-17 21:17:01","","BTC/USD","Bitcoin / USD","",""
"39889310603668","12122.62","-0.77","EURd","SWAP","PROCESSED","2023-09-17 21:17:01","","BTC/USD","Bitcoin / USD","",""
"39889188976348","12123.39","-0.23","EURd","SWAP","PROCESSED","2023-09-17 21:15:05","","TSM","Taiwan Semiconductor Manufacturing Co Ltd - ADR (Extended Hours)","",""
"39889188976186","12123.62","-0.23","EURd","SWAP","PROCESSED","2023-09-17 21:15:05","","TSM","Taiwan Semiconductor Manufacturing Co Ltd - ADR (Extended Hours)","",""
"39888667828484","12123.85","-0.47","EURd","SWAP","PROCESSED","2023-09-17 21:06:48","","ETH/USD","Ethereum / USD","",""
"39888666779355","12124.32","-0.47","EURd","SWAP","PROCESSED","2023-09-17 21:06:47","","ETH/USD","Ethereum / USD","",""
"39888573449188","12124.79","-0.33","EURd","SWAP","PROCESSED","2023-09-17 21:05:18","","NVDA","NVIDIA Corp (Extended Hours)","",""
"39888569268753","12125.12","-0.33","EURd","SWAP","PROCESSED","2023-09-17 21:05:14","","NVDA","NVIDIA Corp (Extended Hours)","",""
"39798842608365","12125.45","-0.13","EURd","SWAP","PROCESSED","2023-09-16 21:19:04","","AMD","Advanced Micro Devices Inc (Extended Hours)","",""
"39798842608309","12125.58","-0.13","EURd","SWAP","PROCESSED","2023-09-16 21:19:04","","AMD","Advanced Micro Devices Inc (Extended Hours)","",""
"39798841559554","12125.71","-0.21","EURd","SWAP","PROCESSED","2023-09-16 21:19:03","","AMD","Advanced Micro Devices Inc (Extended Hours)","",""
"39798841559507","12125.92","-0.06","EURd","SWAP","PROCESSED","2023-09-16 21:19:03","","AMD","Advanced Micro Devices Inc (Extended Hours)","",""
"39798577325417","12125.98","-0.77","EURd","SWAP","PROCESSED","2023-09-16 21:14:51","","BTC/USD","Bitcoin / USD","",""
"39798560552896","12126.75","-0.77","EURd","SWAP","PROCESSED","2023-09-16 21:14:35","","BTC/USD","Bitcoin / USD","",""
"39798559504135","12127.52","-0.77","EURd","SWAP","PROCESSED","2023-09-16 21:14:34","","BTC/USD","Bitcoin / USD","",""
"39798472462944","12128.29","-0.23","EURd","SWAP","PROCESSED","2023-09-16 21:13:11","","TSM","Taiwan Semiconductor Manufacturing Co Ltd - ADR (Extended Hours)","",""
"39798472462819","12128.52","-0.23","EURd","SWAP","PROCESSED","2023-09-16 21:13:11","","TSM","Taiwan Semiconductor Manufacturing Co Ltd - ADR (Extended Hours)","",""
"39798112808600","12128.75","-0.48","EURd","SWAP","PROCESSED","2023-09-16 21:07:28","","ETH/USD","Ethereum / USD","",""
"39798111759484","12129.23","-0.48","EURd","SWAP","PROCESSED","2023-09-16 21:07:27","","ETH/USD","Ethereum / USD","",""
"39797874774537","12129.71","-0.33","EURd","SWAP","PROCESSED","2023-09-16 21:03:41","","NVDA","NVIDIA Corp (Extended Hours)","",""
"39797870577470","12130.04","-0.33","EURd","SWAP","PROCESSED","2023-09-16 21:03:37","","NVDA","NVIDIA Corp (Extended Hours)","",""
"39708185876230","12130.37","-0.13","EURd","SWAP","PROCESSED","2023-09-15 21:18:07","","AMD","Advanced Micro Devices Inc (Extended Hours)","",""
"39708184827555","12130.5","-0.13","EURd","SWAP","PROCESSED","2023-09-15 21:18:06","","AMD","Advanced Micro Devices Inc (Extended Hours)","",""
"39708184827227","12130.63","-0.21","EURd","SWAP","PROCESSED","2023-09-15 21:18:06","","AMD","Advanced Micro Devices Inc (Extended Hours)","",""
"39708184827175","12130.84","-0.06","EURd","SWAP","PROCESSED","2023-09-15 21:18:06","","AMD","Advanced Micro Devices Inc (Extended Hours)","",""
"39708147073217","12130.9","-0.77","EURd","SWAP","PROCESSED","2023-09-15 21:17:30","","BTC/USD","Bitcoin / USD","",""
"39708129252848","12131.67","-0.77","EURd","SWAP","PROCESSED","2023-09-15 21:17:13","","BTC/USD","Bitcoin / USD","",""
"39708128204042","12132.44","-0.77","EURd","SWAP","PROCESSED","2023-09-15 21:17:12","","BTC/USD","Bitcoin / USD","",""
"39707966732055","12133.21","-0.23","EURd","SWAP","PROCESSED","2023-09-15 21:14:38","","TSM","Taiwan Semiconductor Manufacturing Co Ltd - ADR (Extended Hours)","",""
"39707966731935","12133.44","-0.23","EURd","SWAP","PROCESSED","2023-09-15 21:14:38","","TSM","Taiwan Semiconductor Manufacturing Co Ltd - ADR (Extended Hours)","",""
"39707909055608","12133.67","-0.47","EURd","SWAP","PROCESSED","2023-09-15 21:13:43","","ETH/USD","Ethereum / USD","",""
"39707908006468","12134.14","-0.47","EURd","SWAP","PROCESSED","2023-09-15 21:13:42","","ETH/USD","Ethereum / USD","",""
"39707734994697","12134.61","-0.33","EURd","SWAP","PROCESSED","2023-09-15 21:10:57","","NVDA","NVIDIA Corp (Extended Hours)","",""
"39707730797723","12134.94","-0.33","EURd","SWAP","PROCESSED","2023-09-15 21:10:53","","NVDA","NVIDIA Corp (Extended Hours)","",""
"39617696917945","12135.27","-0.23","EURd","SWAP","PROCESSED","2023-09-14 21:19:50","","TSM","Taiwan Semiconductor Manufacturing Co Ltd - ADR (Extended Hours)","",""
"39617696917877","12135.5","-0.23","EURd","SWAP","PROCESSED","2023-09-14 21:19:50","","TSM","Taiwan Semiconductor Manufacturing Co Ltd - ADR (Extended Hours)","",""
"39617565841648","12135.73","-0.13","EURd","SWAP","PROCESSED","2023-09-14 21:17:45","","AMD","Advanced Micro Devices Inc (Extended Hours)","",""
"39617564792736","12135.86","-0.22","EURd","SWAP","PROCESSED","2023-09-14 21:17:44","","AMD","Advanced Micro Devices Inc (Extended Hours)","",""
"39617564792676","12136.08","-0.06","EURd","SWAP","PROCESSED","2023-09-14 21:17:44","","AMD","Advanced Micro Devices Inc (Extended Hours)","",""
"39617277482441","12136.14","-0.34","EURd","SWAP","PROCESSED","2023-09-14 21:13:10","","NVDA","NVIDIA Corp (Extended Hours)","",""
"39617272236698","12136.48","-0.34","EURd","SWAP","PROCESSED","2023-09-14 21:13:05","","NVDA","NVIDIA Corp (Extended Hours)","",""
"39617082455908","12136.82","-0.48","EURd","SWAP","PROCESSED","2023-09-14 21:10:04","","ETH/USD","Ethereum / USD","",""
"39617081406756","12137.3","-0.48","EURd","SWAP","PROCESSED","2023-09-14 21:10:03","","ETH/USD","Ethereum / USD","",""
"39616765784415","12137.78","-0.77","EURd","SWAP","PROCESSED","2023-09-14 21:05:02","","BTC/USD","Bitcoin / USD","",""
"39616742716980","12138.55","-0.77","EURd","SWAP","PROCESSED","2023-09-14 21:04:40","","BTC/USD","Bitcoin / USD","",""
"39616741668147","12139.32","-0.77","EURd","SWAP","PROCESSED","2023-09-14 21:04:39","","BTC/USD","Bitcoin / USD","",""
"39598000463005","12140.09","14.65","EURd","TRADE","PROCESSED","2023-09-14 16:06:46","000940dd-0055-311e-0000-4c9e000a4610_000940dd-0055-311e-0000-000081a61598","BTC/USD","Bitcoin / USD","",""
"39527464846181","12125.44","-0.22","EURd","SWAP","PROCESSED","2023-09-13 21:25:38","","TSM","Taiwan Semiconductor Manufacturing Co Ltd - ADR (Extended Hours)","",""
"39527464846168","12125.66","-0.22","EURd","SWAP","PROCESSED","2023-09-13 21:25:38","","TSM","Taiwan Semiconductor Manufacturing Co Ltd - ADR (Extended Hours)","",""
"39527281357640","12125.88","-0.21","EURd","SWAP","PROCESSED","2023-09-13 21:22:43","","AMD","Advanced Micro Devices Inc (Extended Hours)","",""
"39527281357590","12126.09","-0.06","EURd","SWAP","PROCESSED","2023-09-13 21:22:43","","AMD","Advanced Micro Devices Inc (Extended Hours)","",""
"39526892327244","12126.15","-0.34","EURd","SWAP","PROCESSED","2023-09-13 21:16:32","","NVDA","NVIDIA Corp (Extended Hours)","",""
"39526740286154","12126.49","-0.75","EURd","SWAP","PROCESSED","2023-09-13 21:14:07","","BTC/USD","Bitcoin / USD","",""
"39526740285963","12127.24","-0.75","EURd","SWAP","PROCESSED","2023-09-13 21:14:07","","BTC/USD","Bitcoin / USD","",""
"39526740285857","12127.99","-0.75","EURd","SWAP","PROCESSED","2023-09-13 21:14:07","","BTC/USD","Bitcoin / USD","",""
"39526527428293","12128.74","-0.47","EURd","SWAP","PROCESSED","2023-09-13 21:10:44","","ETH/USD","Ethereum / USD","",""
"39526523231673","12129.21","-0.47","EURd","SWAP","PROCESSED","2023-09-13 21:10:40","","ETH/USD","Ethereum / USD","",""
"39502595774663","12129.68","18.35","EURd","TRADE","PROCESSED","2023-09-13 14:50:21","000940dd-0055-311e-0000-4c9d00094fb2_000940dd-0055-311e-0000-000081a6aea5","BTC/USD","Bitcoin / USD","",""
"39502594726075","12111.33","7.16","EURd","TRADE","PROCESSED","2023-09-13 14:50:20","000940dd-0055-311e-0000-4c9d00094f82_000940dd-0055-311e-0000-000081a61d5d","BTC/USD","Bitcoin / USD","",""
"39502588434599","12104.17","27.13","EURd","TRADE","PROCESSED","2023-09-13 14:50:14","0015421d-0055-311e-0000-4c9d0004678b_0015421d-0055-311e-0000-000080e55caf","ETH/USD","Ethereum / USD","",""
"39436873132673","12077.04","-0.21","EURd","SWAP","PROCESSED","2023-09-12 21:25:43","","AMD","Advanced Micro Devices Inc (Extended Hours)","",""
"39436873132667","12077.25","-0.06","EURd","SWAP","PROCESSED","2023-09-12 21:25:43","","AMD","Advanced Micro Devices Inc (Extended Hours)","",""
"39436659227649","12077.31","-0.22","EURd","SWAP","PROCESSED","2023-09-12 21:22:19","","TSM","Taiwan Semiconductor Manufacturing Co Ltd - ADR (Extended Hours)","",""
"39436301655371","12077.53","-0.33","EURd","SWAP","PROCESSED","2023-09-12 21:16:38","","NVDA","NVIDIA Corp (Extended Hours)","",""
"39435641052814","12077.86","-0.46","EURd","SWAP","PROCESSED","2023-09-12 21:06:08","","ETH/USD","Ethereum / USD","",""
"39435637905415","12078.32","-0.46","EURd","SWAP","PROCESSED","2023-09-12 21:06:05","","ETH/USD","Ethereum / USD","",""
"39435636856215","12078.78","-0.46","EURd","SWAP","PROCESSED","2023-09-12 21:06:04","","ETH/USD","Ethereum / USD","",""
"39435466993270","12079.24","-0.75","EURd","SWAP","PROCESSED","2023-09-12 21:03:22","","BTC/USD","Bitcoin / USD","",""
"39435462796606","12079.99","-0.75","EURd","SWAP","PROCESSED","2023-09-12 21:03:18","","BTC/USD","Bitcoin / USD","",""
"39435462796280","12080.74","-0.75","EURd","SWAP","PROCESSED","2023-09-12 21:03:18","","BTC/USD","Bitcoin / USD","",""
"39435461747525","12081.49","-0.75","EURd","SWAP","PROCESSED","2023-09-12 21:03:17","","BTC/USD","Bitcoin / USD","",""
"39435461747226","12082.24","-0.75","EURd","SWAP","PROCESSED","2023-09-12 21:03:17","","BTC/USD","Bitcoin / USD","",""
"39346269867593","12082.99","-0.21","EURd","SWAP","PROCESSED","2023-09-11 21:25:37","","AMD","Advanced Micro Devices Inc (Extended Hours)","",""
"39346269867584","12083.2","-0.06","EURd","SWAP","PROCESSED","2023-09-11 21:25:37","","AMD","Advanced Micro Devices Inc (Extended Hours)","",""
"39346047578009","12083.26","-0.22","EURd","SWAP","PROCESSED","2023-09-11 21:22:05","","TSM","Taiwan Semiconductor Manufacturing Co Ltd - ADR (Extended Hours)","",""
"39345703646556","12083.48","-0.33","EURd","SWAP","PROCESSED","2023-09-11 21:16:37","","NVDA","NVIDIA Corp (Extended Hours)","",""
"39344968590456","12083.81","-0.45","EURd","SWAP","PROCESSED","2023-09-11 21:04:56","","ETH/USD","Ethereum / USD","",""
"39344967541422","12084.26","-0.45","EURd","SWAP","PROCESSED","2023-09-11 21:04:55","","ETH/USD","Ethereum / USD","",""
"39344871069203","12084.71","-0.73","EURd","SWAP","PROCESSED","2023-09-11 21:03:23","","BTC/USD","Bitcoin / USD","",""
"39344865823463","12085.44","-0.73","EURd","SWAP","PROCESSED","2023-09-11 21:03:18","","BTC/USD","Bitcoin / USD","",""
"39344864774462","12086.17","-0.73","EURd","SWAP","PROCESSED","2023-09-11 21:03:17","","BTC/USD","Bitcoin / USD","",""
"39344864774252","12086.9","-0.73","EURd","SWAP","PROCESSED","2023-09-11 21:03:17","","BTC/USD","Bitcoin / USD","",""
"39344864774159","12087.63","-0.73","EURd","SWAP","PROCESSED","2023-09-11 21:03:17","","BTC/USD","Bitcoin / USD","",""
"39255387692757","12088.36","-0.47","EURd","SWAP","PROCESSED","2023-09-10 21:21:05","","ETH/USD","Ethereum / USD","",""
"39255386643893","12088.83","-0.47","EURd","SWAP","PROCESSED","2023-09-10 21:21:04","","ETH/USD","Ethereum / USD","",""
"39254651588891","12089.3","-0.34","EURd","SWAP","PROCESSED","2023-09-10 21:09:23","","NVDA","NVIDIA Corp (Extended Hours)","",""
"39254511076489","12089.64","-0.22","EURd","SWAP","PROCESSED","2023-09-10 21:07:09","","TSM","Taiwan Semiconductor Manufacturing Co Ltd - ADR (Extended Hours)","",""
"39254424052998","12089.86","-0.75","EURd","SWAP","PROCESSED","2023-09-10 21:05:46","","BTC/USD","Bitcoin / USD","",""
"39254416709184","12090.61","-0.75","EURd","SWAP","PROCESSED","2023-09-10 21:05:39","","BTC/USD","Bitcoin / USD","",""
"39254415660169","12091.36","-0.75","EURd","SWAP","PROCESSED","2023-09-10 21:05:38","","BTC/USD","Bitcoin / USD","",""
"39254415659970","12092.11","-0.75","EURd","SWAP","PROCESSED","2023-09-10 21:05:38","","BTC/USD","Bitcoin / USD","",""
"39254415659853","12092.86","-0.75","EURd","SWAP","PROCESSED","2023-09-10 21:05:38","","BTC/USD","Bitcoin / USD","",""
"39164917610402","12093.61","-0.21","EURd","SWAP","PROCESSED","2023-09-09 21:23:06","","AMD","Advanced Micro Devices Inc (Extended Hours)","",""
"39164917610393","12093.82","-0.06","EURd","SWAP","PROCESSED","2023-09-09 21:23:06","","AMD","Advanced Micro Devices Inc (Extended Hours)","",""
"39164641835191","12093.88","-0.75","EURd","SWAP","PROCESSED","2023-09-09 21:18:43","","BTC/USD","Bitcoin / USD","",""
"39164634491090","12094.63","-0.75","EURd","SWAP","PROCESSED","2023-09-09 21:18:36","","BTC/USD","Bitcoin / USD","",""
"39164633441852","12095.38","-0.75","EURd","SWAP","PROCESSED","2023-09-09 21:18:35","","BTC/USD","Bitcoin / USD","",""
"39164633441624","12096.13","-0.75","EURd","SWAP","PROCESSED","2023-09-09 21:18:35","","BTC/USD","Bitcoin / USD","",""
"39164633441416","12096.88","-0.75","EURd","SWAP","PROCESSED","2023-09-09 21:18:35","","BTC/USD","Bitcoin / USD","",""
"39164544314398","12097.63","-0.48","EURd","SWAP","PROCESSED","2023-09-09 21:17:10","","ETH/USD","Ethereum / USD","",""
"39164543265253","12098.11","-0.48","EURd","SWAP","PROCESSED","2023-09-09 21:17:09","","ETH/USD","Ethereum / USD","",""
"39163671902547","12098.59","-0.22","EURd","SWAP","PROCESSED","2023-09-09 21:03:18","","TSM","Taiwan Semiconductor Manufacturing Co Ltd - ADR (Extended Hours)","",""
"39163564941301","12098.81","-0.34","EURd","SWAP","PROCESSED","2023-09-09 21:01:36","","NVDA","NVIDIA Corp (Extended Hours)","",""
"39074473726942","12099.15","-0.48","EURd","SWAP","PROCESSED","2023-09-08 21:25:32","","ETH/USD","Ethereum / USD","",""
"39074473726909","12099.63","-0.48","EURd","SWAP","PROCESSED","2023-09-08 21:25:32","","ETH/USD","Ethereum / USD","",""
"39074419196067","12100.11","-0.22","EURd","SWAP","PROCESSED","2023-09-08 21:24:40","","TSM","Taiwan Semiconductor Manufacturing Co Ltd - ADR (Extended Hours)","",""
"39073965168198","12100.33","-0.34","EURd","SWAP","PROCESSED","2023-09-08 21:17:27","","NVDA","NVIDIA Corp (Extended Hours)","",""
"39073781667149","12100.67","-0.21","EURd","SWAP","PROCESSED","2023-09-08 21:14:32","","AMD","Advanced Micro Devices Inc (Extended Hours)","",""
"39073781667083","12100.88","-0.06","EURd","SWAP","PROCESSED","2023-09-08 21:14:32","","AMD","Advanced Micro Devices Inc (Extended Hours)","",""
"39073516381643","12100.94","-0.75","EURd","SWAP","PROCESSED","2023-09-08 21:10:19","","BTC/USD","Bitcoin / USD","",""
"39073511135456","12101.69","-0.75","EURd","SWAP","PROCESSED","2023-09-08 21:10:14","","BTC/USD","Bitcoin / USD","",""
"39073509037338","12102.44","-0.75","EURd","SWAP","PROCESSED","2023-09-08 21:10:12","","BTC/USD","Bitcoin / USD","",""
"39073509037154","12103.19","-0.75","EURd","SWAP","PROCESSED","2023-09-08 21:10:12","","BTC/USD","Bitcoin / USD","",""
"39073507988460","12103.94","-0.75","EURd","SWAP","PROCESSED","2023-09-08 21:10:11","","BTC/USD","Bitcoin / USD","",""
"38983821192557","12104.69","-0.76","EURd","SWAP","PROCESSED","2023-09-07 21:24:39","","BTC/USD","Bitcoin / USD","",""
"38983811751722","12105.45","-0.76","EURd","SWAP","PROCESSED","2023-09-07 21:24:30","","BTC/USD","Bitcoin / USD","",""
"38983809653803","12106.21","-0.76","EURd","SWAP","PROCESSED","2023-09-07 21:24:28","","BTC/USD","Bitcoin / USD","",""
"38983809653652","12106.97","-0.76","EURd","SWAP","PROCESSED","2023-09-07 21:24:28","","BTC/USD","Bitcoin / USD","",""
"38983808604989","12107.73","-0.76","EURd","SWAP","PROCESSED","2023-09-07 21:24:27","","BTC/USD","Bitcoin / USD","",""
"38983498220507","12108.49","-0.22","EURd","SWAP","PROCESSED","2023-09-07 21:19:31","","AMD","Advanced Micro Devices Inc (Extended Hours)","",""
"38983497171878","12108.71","-0.06","EURd","SWAP","PROCESSED","2023-09-07 21:19:30","","AMD","Advanced Micro Devices Inc (Extended Hours)","",""
"38983062028006","12108.77","-0.35","EURd","SWAP","PROCESSED","2023-09-07 21:12:35","","NVDA","NVIDIA Corp (Extended Hours)","",""
"38982664603778","12109.12","-0.22","EURd","SWAP","PROCESSED","2023-09-07 21:06:16","","TSM","Taiwan Semiconductor Manufacturing Co Ltd - ADR (Extended Hours)","",""
"38982597494802","12109.34","-0.48","EURd","SWAP","PROCESSED","2023-09-07 21:05:12","","ETH/USD","Ethereum / USD","",""
"38982596445626","12109.82","-0.48","EURd","SWAP","PROCESSED","2023-09-07 21:05:11","","ETH/USD","Ethereum / USD","",""
"38893446522074","12110.3","-0.48","EURd","SWAP","PROCESSED","2023-09-06 21:28:11","","ETH/USD","Ethereum / USD","",""
"38893445473297","12110.78","-0.48","EURd","SWAP","PROCESSED","2023-09-06 21:28:10","","ETH/USD","Ethereum / USD","",""
"38893416106744","12111.26","-0.34","EURd","SWAP","PROCESSED","2023-09-06 21:27:42","","NVDA","NVIDIA Corp (Extended Hours)","",""
"38893279792565","12111.6","-0.23","EURd","SWAP","PROCESSED","2023-09-06 21:25:32","","TSM","Taiwan Semiconductor Manufacturing Co Ltd - ADR (Extended Hours)","",""
"38892256393920","12111.83","-0.21","EURd","SWAP","PROCESSED","2023-09-06 21:09:16","","AMD","Advanced Micro Devices Inc (Extended Hours)","",""
"38892256393874","12112.04","-0.06","EURd","SWAP","PROCESSED","2023-09-06 21:09:16","","AMD","Advanced Micro Devices Inc (Extended Hours)","",""
"38892242756809","12112.1","-0.75","EURd","SWAP","PROCESSED","2023-09-06 21:09:03","","BTC/USD","Bitcoin / USD","",""
"38892232266830","12112.85","-0.75","EURd","SWAP","PROCESSED","2023-09-06 21:08:53","","BTC/USD","Bitcoin / USD","",""
"38892232266686","12113.6","-0.75","EURd","SWAP","PROCESSED","2023-09-06 21:08:53","","BTC/USD","Bitcoin / USD","",""
"38892231217982","12114.35","-0.75","EURd","SWAP","PROCESSED","2023-09-06 21:08:52","","BTC/USD","Bitcoin / USD","",""
"38892231217706","12115.1","-0.75","EURd","SWAP","PROCESSED","2023-09-06 21:08:52","","BTC/USD","Bitcoin / USD","",""
"38801913182083","12115.85","-0.23","EURd","SWAP","PROCESSED","2023-09-05 21:13:18","","TSM","Taiwan Semiconductor Manufacturing Co Ltd - ADR (Extended Hours)","",""
"38801822996695","12116.08","-0.22","EURd","SWAP","PROCESSED","2023-09-05 21:11:52","","AMD","Advanced Micro Devices Inc (Extended Hours)","",""
"38801822996672","12116.3","-0.06","EURd","SWAP","PROCESSED","2023-09-05 21:11:52","","AMD","Advanced Micro Devices Inc (Extended Hours)","",""
"38801439220551","12116.36","-0.75","EURd","SWAP","PROCESSED","2023-09-05 21:05:46","","BTC/USD","Bitcoin / USD","",""
"38801430827747","12117.11","-0.75","EURd","SWAP","PROCESSED","2023-09-05 21:05:38","","BTC/USD","Bitcoin / USD","",""
"38801430827595","12117.86","-0.75","EURd","SWAP","PROCESSED","2023-09-05 21:05:38","","BTC/USD","Bitcoin / USD","",""
"38801430827469","12118.61","-0.75","EURd","SWAP","PROCESSED","2023-09-05 21:05:38","","BTC/USD","Bitcoin / USD","",""
"38801430827289","12119.36","-0.75","EURd","SWAP","PROCESSED","2023-09-05 21:05:38","","BTC/USD","Bitcoin / USD","",""
"38801203291563","12120.11","-0.48","EURd","SWAP","PROCESSED","2023-09-05 21:02:01","","ETH/USD","Ethereum / USD","",""
"38801201193711","12120.59","-0.48","EURd","SWAP","PROCESSED","2023-09-05 21:01:59","","ETH/USD","Ethereum / USD","",""
"38801170787039","12121.07","-0.36","EURd","SWAP","PROCESSED","2023-09-05 21:01:30","","NVDA","NVIDIA Corp (Extended Hours)","",""
"38791134865553","12121.43","6.25","EURd","TRADE","PROCESSED","2023-09-05 18:21:59","00001344-0055-311e-0000-4c950010cf23_00001344-0055-311e-0000-00008024055d","AMD","Advanced Micro Devices Inc (Extended Hours)","",""
"38791131719818","12115.18","12.21","EURd","TRADE","PROCESSED","2023-09-05 18:21:56","00001344-0055-311e-0000-4c950010ced6_00001344-0055-311e-0000-00008024055f","AMD","Advanced Micro Devices Inc (Extended Hours)","",""
"38782493555328","12102.97","1.63","EURd","TRADE","PROCESSED","2023-09-05 16:04:38","00513301-0055-311e-0000-4c95000b11f8_00513301-0055-311e-0000-00008086350b","TSLA","Tesla Inc (Extended Hours)","",""
"38782035325658","12101.34","-3.45","EURd","TRADE","PROCESSED","2023-09-05 15:57:21","00001344-0055-311e-0000-4c95000bda10_00001344-0055-311e-0000-000080240551","AMD","Advanced Micro Devices Inc (Extended Hours)","",""
"38782030082763","12104.79","2.33","EURd","TRADE","PROCESSED","2023-09-05 15:57:16","00001344-0055-311e-0000-4c95000bd8be_00001344-0055-311e-0000-00008024054c","AMD","Advanced Micro Devices Inc (Extended Hours)","",""
"38781912641724","12102.46","15.47","EURd","TRADE","PROCESSED","2023-09-05 15:55:24","00001344-0055-311e-0000-4c95000bc145_00001344-0055-311e-0000-0000802404b8","AMD","Advanced Micro Devices Inc (Extended Hours)","",""
"38781892718665","12086.99","2.61","EURd","TRADE","PROCESSED","2023-09-05 15:55:05","004433cd-0055-311e-0000-4c95000bbea8_004433cd-0055-311e-0000-00008020035d","QCOM","QUALCOMM Inc (Extended Hours)","",""
"38776469482576","12084.38","13.11","EURd","TRADE","PROCESSED","2023-09-05 14:28:53","00513301-0055-311e-0000-4c95000959a4_00513301-0055-311e-0000-0000808622d1","TSLA","Tesla Inc (Extended Hours)","",""
"38776469482575","12071.27","13.36","EURd","TRADE","PROCESSED","2023-09-05 14:28:53","00513301-0055-311e-0000-4c95000959a0_00513301-0055-311e-0000-0000808622d5","TSLA","Tesla Inc (Extended Hours)","",""
"38776468433998","12057.91","-9.31","EURd","TRADE","PROCESSED","2023-09-05 14:28:52","00513301-0055-311e-0000-4c950009599c_00513301-0055-311e-0000-00008086135b","TSLA","Tesla Inc (Extended Hours)","",""
"38775417753211","12067.22","3.17","EURd","TRADE","PROCESSED","2023-09-05 14:12:10","004433cd-0055-311e-0000-4c9500063caa_004433cd-0055-311e-0000-00008023000d","QCOM","QUALCOMM Inc (Extended Hours)","",""
"38711303632521","12064.05","-0.23","EURd","SWAP","PROCESSED","2023-09-04 21:13:06","","TSM","Taiwan Semiconductor Manufacturing Co Ltd - ADR (Extended Hours)","",""
"38711302583114","12064.28","-0.21","EURd","SWAP","PROCESSED","2023-09-04 21:13:05","","AMD","Advanced Micro Devices Inc (Extended Hours)","",""
"38711302583061","12064.49","-0.06","EURd","SWAP","PROCESSED","2023-09-04 21:13:05","","AMD","Advanced Micro Devices Inc (Extended Hours)","",""
"38711253293724","12064.55","-0.12","EURd","SWAP","PROCESSED","2023-09-04 21:12:18","","TSLA","Tesla Inc (Extended Hours)","",""
"38711253293681","12064.67","-0.12","EURd","SWAP","PROCESSED","2023-09-04 21:12:18","","TSLA","Tesla Inc (Extended Hours)","",""
"38711248048737","12064.79","-0.12","EURd","SWAP","PROCESSED","2023-09-04 21:12:13","","TSLA","Tesla Inc (Extended Hours)","",""
"38711238607463","12064.91","-0.74","EURd","SWAP","PROCESSED","2023-09-04 21:12:04","","BTC/USD","Bitcoin / USD","",""
"38711237558701","12065.65","-0.74","EURd","SWAP","PROCESSED","2023-09-04 21:12:03","","BTC/USD","Bitcoin / USD","",""
"38711237558575","12066.39","-0.74","EURd","SWAP","PROCESSED","2023-09-04 21:12:03","","BTC/USD","Bitcoin / USD","",""
"38711236525915","12067.13","-0.74","EURd","SWAP","PROCESSED","2023-09-04 21:12:02","","BTC/USD","Bitcoin / USD","",""
"38710956541993","12067.87","-0.47","EURd","SWAP","PROCESSED","2023-09-04 21:07:35","","ETH/USD","Ethereum / USD","",""
"38710953394886","12068.34","-0.47","EURd","SWAP","PROCESSED","2023-09-04 21:07:32","","ETH/USD","Ethereum / USD","",""
"38710823379908","12068.81","-0.29","EURd","SWAP","PROCESSED","2023-09-04 21:05:28","","QCOM","QUALCOMM Inc (Extended Hours)","",""
"38710823379809","12069.1","-0.29","EURd","SWAP","PROCESSED","2023-09-04 21:05:28","","QCOM","QUALCOMM Inc (Extended Hours)","",""
"38621630452113","12069.39","-0.47","EURd","SWAP","PROCESSED","2023-09-03 21:27:47","","ETH/USD","Ethereum / USD","",""
"38621628354245","12069.86","-0.47","EURd","SWAP","PROCESSED","2023-09-03 21:27:45","","ETH/USD","Ethereum / USD","",""
"38621254013284","12070.33","-0.12","EURd","SWAP","PROCESSED","2023-09-03 21:21:48","","TSLA","Tesla Inc (Extended Hours)","",""
"38621254013256","12070.45","-0.12","EURd","SWAP","PROCESSED","2023-09-03 21:21:48","","TSLA","Tesla Inc (Extended Hours)","",""
"38621252963999","12070.57","-0.12","EURd","SWAP","PROCESSED","2023-09-03 21:21:47","","TSLA","Tesla Inc (Extended Hours)","",""
"38621211020487","12070.69","-0.29","EURd","SWAP","PROCESSED","2023-09-03 21:21:07","","QCOM","QUALCOMM Inc (Extended Hours)","",""
"38621209971808","12070.98","-0.29","EURd","SWAP","PROCESSED","2023-09-03 21:21:06","","QCOM","QUALCOMM Inc (Extended Hours)","",""
"38621101974903","12071.27","-0.23","EURd","SWAP","PROCESSED","2023-09-03 21:19:23","","TSM","Taiwan Semiconductor Manufacturing Co Ltd - ADR (Extended Hours)","",""
"38620262069318","12071.5","-0.21","EURd","SWAP","PROCESSED","2023-09-03 21:06:02","","AMD","Advanced Micro Devices Inc (Extended Hours)","",""
"38620262069272","12071.71","-0.06","EURd","SWAP","PROCESSED","2023-09-03 21:06:02","","AMD","Advanced Micro Devices Inc (Extended Hours)","",""
"38620004115233","12071.77","-0.75","EURd","SWAP","PROCESSED","2023-09-03 21:01:56","","BTC/USD","Bitcoin / USD","",""
"38620004115079","12072.52","-0.75","EURd","SWAP","PROCESSED","2023-09-03 21:01:56","","BTC/USD","Bitcoin / USD","",""
"38620004114988","12073.27","-0.75","EURd","SWAP","PROCESSED","2023-09-03 21:01:56","","BTC/USD","Bitcoin / USD","",""
"38620003066212","12074.02","-0.75","EURd","SWAP","PROCESSED","2023-09-03 21:01:55","","BTC/USD","Bitcoin / USD","",""
"38533811159352","12074.77","10.04","EURd","TRADE","PROCESSED","2023-09-02 22:11:56","0015421d-0055-311e-0000-4c9200046a7c_0015421d-0055-311e-0000-000080e50e19","ETH/USD","Ethereum / USD","",""
"38531159313077","12064.73","-0.74","EURd","SWAP","PROCESSED","2023-09-02 21:29:47","","BTC/USD","Bitcoin / USD","",""
"38531158264408","12065.47","-0.74","EURd","SWAP","PROCESSED","2023-09-02 21:29:46","","BTC/USD","Bitcoin / USD","",""
"38531158264354","12066.21","-0.74","EURd","SWAP","PROCESSED","2023-09-02 21:29:46","","BTC/USD","Bitcoin / USD","",""
"38531158264249","12066.95","-0.74","EURd","SWAP","PROCESSED","2023-09-02 21:29:46","","BTC/USD","Bitcoin / USD","",""
"38531129960798","12067.69","-0.23","EURd","SWAP","PROCESSED","2023-09-02 21:29:19","","TSM","Taiwan Semiconductor Manufacturing Co Ltd - ADR (Extended Hours)","",""
"38531126814005","12067.92","-0.12","EURd","SWAP","PROCESSED","2023-09-02 21:29:16","","TSLA","Tesla Inc (Extended Hours)","",""
"38531126813987","12068.04","-0.12","EURd","SWAP","PROCESSED","2023-09-02 21:29:16","","TSLA","Tesla Inc (Extended Hours)","",""
"38531125764973","12068.16","-0.12","EURd","SWAP","PROCESSED","2023-09-02 21:29:15","","TSLA","Tesla Inc (Extended Hours)","",""
"38530398051631","12068.28","-0.29","EURd","SWAP","PROCESSED","2023-09-02 21:17:41","","QCOM","QUALCOMM Inc (Extended Hours)","",""
"38530398051520","12068.57","-0.29","EURd","SWAP","PROCESSED","2023-09-02 21:17:41","","QCOM","QUALCOMM Inc (Extended Hours)","",""
"38530264875277","12068.86","-0.21","EURd","SWAP","PROCESSED","2023-09-02 21:15:34","","AMD","Advanced Micro Devices Inc (Extended Hours)","",""
"38530264875245","12069.07","-0.06","EURd","SWAP","PROCESSED","2023-09-02 21:15:34","","AMD","Advanced Micro Devices Inc (Extended Hours)","",""
"38529608470957","12069.13","-0.47","EURd","SWAP","PROCESSED","2023-09-02 21:05:08","","ETH/USD","Ethereum / USD","",""
"38529607422188","12069.6","-0.47","EURd","SWAP","PROCESSED","2023-09-02 21:05:07","","ETH/USD","Ethereum / USD","",""
"38440623174948","12070.07","-0.12","EURd","SWAP","PROCESSED","2023-09-01 21:30:45","","TSLA","Tesla Inc (Extended Hours)","",""
"38440623174932","12070.19","-0.12","EURd","SWAP","PROCESSED","2023-09-01 21:30:45","","TSLA","Tesla Inc (Extended Hours)","",""
"38440622125952","12070.31","-0.12","EURd","SWAP","PROCESSED","2023-09-01 21:30:44","","TSLA","Tesla Inc (Extended Hours)","",""
"38440591709331","12070.43","-0.74","EURd","SWAP","PROCESSED","2023-09-01 21:30:15","","BTC/USD","Bitcoin / USD","",""
"38440591709237","12071.17","-0.74","EURd","SWAP","PROCESSED","2023-09-01 21:30:15","","BTC/USD","Bitcoin / USD","",""
"38440591709175","12071.91","-0.74","EURd","SWAP","PROCESSED","2023-09-01 21:30:15","","BTC/USD","Bitcoin / USD","",""
"38440591709082","12072.65","-0.74","EURd","SWAP","PROCESSED","2023-09-01 21:30:15","","BTC/USD","Bitcoin / USD","",""
"38440493144199","12073.39","-0.23","EURd","SWAP","PROCESSED","2023-09-01 21:28:41","","TSM","Taiwan Semiconductor Manufacturing Co Ltd - ADR (Extended Hours)","",""
"38440103077204","12073.62","-0.47","EURd","SWAP","PROCESSED","2023-09-01 21:22:29","","ETH/USD","Ethereum / USD","",""
"38440103077078","12074.09","-0.47","EURd","SWAP","PROCESSED","2023-09-01 21:22:29","","ETH/USD","Ethereum / USD","",""
"38439719304249","12074.56","-0.29","EURd","SWAP","PROCESSED","2023-09-01 21:16:23","","QCOM","QUALCOMM Inc (Extended Hours)","",""
"38439718255265","12074.85","-0.29","EURd","SWAP","PROCESSED","2023-09-01 21:16:22","","QCOM","QUALCOMM Inc (Extended Hours)","",""
"38439368019384","12075.14","-0.21","EURd","SWAP","PROCESSED","2023-09-01 21:10:48","","AMD","Advanced Micro Devices Inc (Extended Hours)","",""
"38439368019353","12075.35","-0.06","EURd","SWAP","PROCESSED","2023-09-01 21:10:48","","AMD","Advanced Micro Devices Inc (Extended Hours)","",""
"38428255209390","12075.41","20.59","EURd","TRADE","PROCESSED","2023-09-01 18:14:10","00001344-0055-311e-0000-4c910011824c_00001344-0055-311e-0000-00008024019a","AMD","Advanced Micro Devices Inc (Extended Hours)","",""
"38428253112225","12054.82","12.89","EURd","TRADE","PROCESSED","2023-09-01 18:14:08","00001344-0055-311e-0000-4c91001181ea_00001344-0055-311e-0000-000080220f53","AMD","Advanced Micro Devices Inc (Extended Hours)","",""
"38428251015066","12041.93","26.89","EURd","TRADE","PROCESSED","2023-09-01 18:14:06","00001344-0055-311e-0000-4c91001181a7_00001344-0055-311e-0000-0000802305fa","AMD","Advanced Micro Devices Inc (Extended Hours)","",""
"38409750988890","12015.04","4.23","EURd","TRADE","PROCESSED","2023-09-01 13:20:03","00081081-0055-311e-0000-4c9100017bb5_00081081-0055-311e-0000-0000802301da","BABA","Alibaba Group Holding Limited (Extended Hours)","",""
"38350179298337","12010.81","-0.75","EURd","SWAP","PROCESSED","2023-08-31 21:33:11","","BTC/USD","Bitcoin / USD","",""
"38350179298267","12011.56","-0.75","EURd","SWAP","PROCESSED","2023-08-31 21:33:11","","BTC/USD","Bitcoin / USD","",""
"38350179298135","12012.31","-0.75","EURd","SWAP","PROCESSED","2023-08-31 21:33:11","","BTC/USD","Bitcoin / USD","",""
"38350078636912","12013.06","-0.23","EURd","SWAP","PROCESSED","2023-08-31 21:31:35","","TSM","Taiwan Semiconductor Manufacturing Co Ltd - ADR (Extended Hours)","",""
"38349651856990","12013.29","-0.13","EURd","SWAP","PROCESSED","2023-08-31 21:24:48","","AMD","Advanced Micro Devices Inc (Extended Hours)","",""
"38349650808358","12013.42","-0.26","EURd","SWAP","PROCESSED","2023-08-31 21:24:47","","AMD","Advanced Micro Devices Inc (Extended Hours)","",""
"38349650808086","12013.68","-0.06","EURd","SWAP","PROCESSED","2023-08-31 21:24:47","","AMD","Advanced Micro Devices Inc (Extended Hours)","",""
"38349650808055","12013.74","-0.21","EURd","SWAP","PROCESSED","2023-08-31 21:24:47","","AMD","Advanced Micro Devices Inc (Extended Hours)","",""
"38349649759452","12013.95","-0.06","EURd","SWAP","PROCESSED","2023-08-31 21:24:46","","AMD","Advanced Micro Devices Inc (Extended Hours)","",""
"38349304779599","12014.01","-0.28","EURd","SWAP","PROCESSED","2023-08-31 21:19:17","","QCOM","QUALCOMM Inc (Extended Hours)","",""
"38348460683462","12014.29","-0.23","EURd","SWAP","PROCESSED","2023-08-31 21:05:52","","BABA","Alibaba Group Holding Limited (Extended Hours)","",""
"38343654009074","12014.52","10.42","EURd","TRADE","PROCESSED","2023-08-31 19:49:28","004433cd-0055-311e-0000-4c9000127394_004433cd-0055-311e-0000-000080220015","QCOM","QUALCOMM Inc (Extended Hours)","",""
"38330178751355","12004.1","14.2","EURd","TRADE","PROCESSED","2023-08-31 16:15:17","00000182-0055-311e-0000-4c90000a9c24_00000182-0055-311e-0000-0000804f036a","META","Meta Platforms Inc (Extended Hours)","",""
"38330175605618","11989.9","5.18","EURd","TRADE","PROCESSED","2023-08-31 16:15:14","00513301-0055-311e-0000-4c90000a9be0_00513301-0055-311e-0000-000080854254","TSLA","Tesla Inc (Extended Hours)","",""
"38330175605617","11984.72","12.08","EURd","TRADE","PROCESSED","2023-08-31 16:15:14","00513301-0055-311e-0000-4c90000a9bdf_00513301-0055-311e-0000-00008085424c","TSLA","Tesla Inc (Extended Hours)","",""
"38330175605615","11972.64","10.33","EURd","TRADE","PROCESSED","2023-08-31 16:15:14","00513301-0055-311e-0000-4c90000a9bde_00513301-0055-311e-0000-00008085422d","TSLA","Tesla Inc (Extended Hours)","",""
"38259432376286","11962.31","-0.13","EURd","SWAP","PROCESSED","2023-08-30 21:30:48","","TSLA","Tesla Inc (Extended Hours)","",""
"38259432376255","11962.44","-0.31","EURd","SWAP","PROCESSED","2023-08-30 21:30:48","","TSLA","Tesla Inc (Extended Hours)","",""
"38259432376231","11962.75","-0.31","EURd","SWAP","PROCESSED","2023-08-30 21:30:48","","TSLA","Tesla Inc (Extended Hours)","",""
"38259338017231","11963.06","-0.77","EURd","SWAP","PROCESSED","2023-08-30 21:29:18","","BTC/USD","Bitcoin / USD","",""
"38259240495162","11963.83","-0.36","EURd","SWAP","PROCESSED","2023-08-30 21:27:45","","META","Meta Platforms Inc (Extended Hours)","",""
"38258987789449","11964.19","-0.23","EURd","SWAP","PROCESSED","2023-08-30 21:23:44","","TSM","Taiwan Semiconductor Manufacturing Co Ltd - ADR (Extended Hours)","",""
"38258262178798","11964.42","-0.26","EURd","SWAP","PROCESSED","2023-08-30 21:12:12","","AMD","Advanced Micro Devices Inc (Extended Hours)","",""
"38258261129876","11964.68","-0.05","EURd","SWAP","PROCESSED","2023-08-30 21:12:11","","AMD","Advanced Micro Devices Inc (Extended Hours)","",""
"38258261129843","11964.73","-0.21","EURd","SWAP","PROCESSED","2023-08-30 21:12:11","","AMD","Advanced Micro Devices Inc (Extended Hours)","",""
"38258261129809","11964.94","-0.05","EURd","SWAP","PROCESSED","2023-08-30 21:12:11","","AMD","Advanced Micro Devices Inc (Extended Hours)","",""
"38257951795377","11964.99","-0.27","EURd","SWAP","PROCESSED","2023-08-30 21:07:16","","QCOM","QUALCOMM Inc (Extended Hours)","",""
"38257950746657","11965.26","-0.27","EURd","SWAP","PROCESSED","2023-08-30 21:07:15","","QCOM","QUALCOMM Inc (Extended Hours)","",""
"38257920327740","11965.53","-0.23","EURd","SWAP","PROCESSED","2023-08-30 21:06:46","","BABA","Alibaba Group Holding Limited (Extended Hours)","",""
"38252213980673","11965.76","11.61","EURd","TRADE","PROCESSED","2023-08-30 19:36:04","0015421d-0055-311e-0000-4c8f00065542_0015421d-0055-311e-0000-000080e340e5","ETH/USD","Ethereum / USD","",""
"38252210834939","11954.15","14.01","EURd","TRADE","PROCESSED","2023-08-30 19:36:01","0004140c-0055-311e-0000-4c8f000ddb31_0004140c-0055-311e-0000-00008050343d","AAPL","Apple Inc (Extended Hours)","",""
"38252210834938","11940.14","-1.13","EURd","TRADE","PROCESSED","2023-08-30 19:36:01","0004140c-0055-311e-0000-4c8f000ddb30_0004140c-0055-311e-0000-000080502ed2","AAPL","Apple Inc (Extended Hours)","",""
"38252210834937","11941.27","5.8","EURd","TRADE","PROCESSED","2023-08-30 19:36:01","0004140c-0055-311e-0000-4c8f000ddb2f_0004140c-0055-311e-0000-0000805032c1","AAPL","Apple Inc (Extended Hours)","",""
"38252210834935","11935.47","6.07","EURd","TRADE","PROCESSED","2023-08-30 19:36:01","0004140c-0055-311e-0000-4c8f000ddb2e_0004140c-0055-311e-0000-0000805032bd","AAPL","Apple Inc (Extended Hours)","",""
"38252208737679","11929.4","122.65","EURd","TRADE","PROCESSED","2023-08-30 19:35:59","00513301-0055-311e-0000-4c8f000ddb1a_00513301-0055-311e-0000-000080848183","TSLA","Tesla Inc (Extended Hours)","",""
"38252208737673","11806.75","19.78","EURd","TRADE","PROCESSED","2023-08-30 19:35:59","00513301-0055-311e-0000-4c8f000ddb19_00513301-0055-311e-0000-00008080f30b","TSLA","Tesla Inc (Extended Hours)","",""
"38252208737667","11786.97","-23.08","EURd","TRADE","PROCESSED","2023-08-30 19:35:59","00513301-0055-311e-0000-4c8f000ddb18_00513301-0055-311e-0000-00008080d0d5","TSLA","Tesla Inc (Extended Hours)","",""
"38252208737663","11810.05","85.48","EURd","TRADE","PROCESSED","2023-08-30 19:35:59","00513301-0055-311e-0000-4c8f000ddb17_00513301-0055-311e-0000-00008083186e","TSLA","Tesla Inc (Extended Hours)","",""
"38252208737656","11724.57","15.67","EURd","TRADE","PROCESSED","2023-08-30 19:35:59","00513301-0055-311e-0000-4c8f000ddb16_00513301-0055-311e-0000-0000808137b3","TSLA","Tesla Inc (Extended Hours)","",""
"38252208737645","11708.9","5.59","EURd","TRADE","PROCESSED","2023-08-30 19:35:59","00513301-0055-311e-0000-4c8f000ddb15_00513301-0055-311e-0000-00008080de9e","TSLA","Tesla Inc (Extended Hours)","",""
"38252208737638","11703.31","38.92","EURd","TRADE","PROCESSED","2023-08-30 19:35:59","00513301-0055-311e-0000-4c8f000ddb14_00513301-0055-311e-0000-0000808125d4","TSLA","Tesla Inc (Extended Hours)","",""
"38168540763760","11664.39","-0.31","EURd","SWAP","PROCESSED","2023-08-29 21:26:07","","TSLA","Tesla Inc (Extended Hours)","",""
"38168534469794","11664.7","-0.31","EURd","SWAP","PROCESSED","2023-08-29 21:26:01","","TSLA","Tesla Inc (Extended Hours)","",""
"38168533420737","11665.01","-0.06","EURd","SWAP","PROCESSED","2023-08-29 21:26:00","","TSLA","Tesla Inc (Extended Hours)","",""
"38168532371832","11665.07","-0.31","EURd","SWAP","PROCESSED","2023-08-29 21:25:59","","TSLA","Tesla Inc (Extended Hours)","",""
"38168531322896","11665.38","-0.13","EURd","SWAP","PROCESSED","2023-08-29 21:25:58","","TSLA","Tesla Inc (Extended Hours)","",""
"38168530274047","11665.51","-0.31","EURd","SWAP","PROCESSED","2023-08-29 21:25:57","","TSLA","Tesla Inc (Extended Hours)","",""
"38168530273918","11665.82","-0.31","EURd","SWAP","PROCESSED","2023-08-29 21:25:57","","TSLA","Tesla Inc (Extended Hours)","",""
"38167881204396","11666.13","-0.5","EURd","SWAP","PROCESSED","2023-08-29 21:15:38","","ETH/USD","Ethereum / USD","",""
"38167807809098","11666.63","-0.14","EURd","SWAP","PROCESSED","2023-08-29 21:14:28","","AAPL","Apple Inc (Extended Hours)","",""
"38167807808945","11666.77","-0.14","EURd","SWAP","PROCESSED","2023-08-29 21:14:28","","AAPL","Apple Inc (Extended Hours)","",""
"38167807808912","11666.91","-0.14","EURd","SWAP","PROCESSED","2023-08-29 21:14:28","","AAPL","Apple Inc (Extended Hours)","",""
"38167806760069","11667.05","-0.14","EURd","SWAP","PROCESSED","2023-08-29 21:14:27","","AAPL","Apple Inc (Extended Hours)","",""
"38167173428980","11667.19","-0.06","EURd","SWAP","PROCESSED","2023-08-29 21:04:23","","AMD","Advanced Micro Devices Inc (Extended Hours)","",""
"38167173428919","11667.25","-0.21","EURd","SWAP","PROCESSED","2023-08-29 21:04:23","","AMD","Advanced Micro Devices Inc (Extended Hours)","",""
"38167172380319","11667.46","-0.06","EURd","SWAP","PROCESSED","2023-08-29 21:04:22","","AMD","Advanced Micro Devices Inc (Extended Hours)","",""
"38167120994454","11667.52","-0.28","EURd","SWAP","PROCESSED","2023-08-29 21:03:33","","QCOM","QUALCOMM Inc (Extended Hours)","",""
"38078192307932","11667.8","-0.3","EURd","SWAP","PROCESSED","2023-08-28 21:30:04","","TSLA","Tesla Inc (Extended Hours)","",""
"38078186013988","11668.1","-0.3","EURd","SWAP","PROCESSED","2023-08-28 21:29:58","","TSLA","Tesla Inc (Extended Hours)","",""
"38078184965010","11668.4","-0.06","EURd","SWAP","PROCESSED","2023-08-28 21:29:57","","TSLA","Tesla Inc (Extended Hours)","",""
"38078183916172","11668.46","-0.3","EURd","SWAP","PROCESSED","2023-08-28 21:29:56","","TSLA","Tesla Inc (Extended Hours)","",""
"38078182867149","11668.76","-0.12","EURd","SWAP","PROCESSED","2023-08-28 21:29:55","","TSLA","Tesla Inc (Extended Hours)","",""
"38078181834642","11668.88","-0.3","EURd","SWAP","PROCESSED","2023-08-28 21:29:54","","TSLA","Tesla Inc (Extended Hours)","",""
"38078181834523","11669.18","-0.3","EURd","SWAP","PROCESSED","2023-08-28 21:29:54","","TSLA","Tesla Inc (Extended Hours)","",""
"38076677126239","11669.48","-0.14","EURd","SWAP","PROCESSED","2023-08-28 21:05:59","","AAPL","Apple Inc (Extended Hours)","",""
"38076677126118","11669.62","-0.14","EURd","SWAP","PROCESSED","2023-08-28 21:05:59","","AAPL","Apple Inc (Extended Hours)","",""
"38076677126087","11669.76","-0.14","EURd","SWAP","PROCESSED","2023-08-28 21:05:59","","AAPL","Apple Inc (Extended Hours)","",""
"38076676077258","11669.9","-0.14","EURd","SWAP","PROCESSED","2023-08-28 21:05:58","","AAPL","Apple Inc (Extended Hours)","",""
"38076672930403","11670.04","-0.28","EURd","SWAP","PROCESSED","2023-08-28 21:05:55","","QCOM","QUALCOMM Inc (Extended Hours)","",""
"38076667685780","11670.32","-0.47","EURd","SWAP","PROCESSED","2023-08-28 21:05:50","","ETH/USD","Ethereum / USD","",""
"38076451674016","11670.79","-0.06","EURd","SWAP","PROCESSED","2023-08-28 21:02:24","","AMD","Advanced Micro Devices Inc (Extended Hours)","",""
"38076450625376","11670.85","-0.2","EURd","SWAP","PROCESSED","2023-08-28 21:02:23","","AMD","Advanced Micro Devices Inc (Extended Hours)","",""
"38076450625348","11671.05","-0.06","EURd","SWAP","PROCESSED","2023-08-28 21:02:23","","AMD","Advanced Micro Devices Inc (Extended Hours)","",""
"37986936840926","11671.11","-0.47","EURd","SWAP","PROCESSED","2023-08-27 21:19:36","","ETH/USD","Ethereum / USD","",""
"37986667350751","11671.58","-0.06","EURd","SWAP","PROCESSED","2023-08-27 21:15:19","","AMD","Advanced Micro Devices Inc (Extended Hours)","",""
"37986666302121","11671.64","-0.2","EURd","SWAP","PROCESSED","2023-08-27 21:15:18","","AMD","Advanced Micro Devices Inc (Extended Hours)","",""
"37986666302095","11671.84","-0.06","EURd","SWAP","PROCESSED","2023-08-27 21:15:18","","AMD","Advanced Micro Devices Inc (Extended Hours)","",""
"37986425131712","11671.9","-0.14","EURd","SWAP","PROCESSED","2023-08-27 21:11:28","","AAPL","Apple Inc (Extended Hours)","",""
"37986425131573","11672.04","-0.14","EURd","SWAP","PROCESSED","2023-08-27 21:11:28","","AAPL","Apple Inc (Extended Hours)","",""
"37986425131545","11672.18","-0.14","EURd","SWAP","PROCESSED","2023-08-27 21:11:28","","AAPL","Apple Inc (Extended Hours)","",""
"37986424082736","11672.32","-0.14","EURd","SWAP","PROCESSED","2023-08-27 21:11:27","","AAPL","Apple Inc (Extended Hours)","",""
"37986059187288","11672.46","-0.27","EURd","SWAP","PROCESSED","2023-08-27 21:05:39","","QCOM","QUALCOMM Inc (Extended Hours)","",""
"37985907132293","11672.73","-0.3","EURd","SWAP","PROCESSED","2023-08-27 21:03:14","","TSLA","Tesla Inc (Extended Hours)","",""
"37985898757135","11673.03","-0.3","EURd","SWAP","PROCESSED","2023-08-27 21:03:06","","TSLA","Tesla Inc (Extended Hours)","",""
"37985897708099","11673.33","-0.06","EURd","SWAP","PROCESSED","2023-08-27 21:03:05","","TSLA","Tesla Inc (Extended Hours)","",""
"37985896659204","11673.39","-0.3","EURd","SWAP","PROCESSED","2023-08-27 21:03:04","","TSLA","Tesla Inc (Extended Hours)","",""
"37985895610074","11673.69","-0.12","EURd","SWAP","PROCESSED","2023-08-27 21:03:03","","TSLA","Tesla Inc (Extended Hours)","",""
"37985894561096","11673.81","-0.3","EURd","SWAP","PROCESSED","2023-08-27 21:03:02","","TSLA","Tesla Inc (Extended Hours)","",""
"37985893512398","11674.11","-0.3","EURd","SWAP","PROCESSED","2023-08-27 21:03:01","","TSLA","Tesla Inc (Extended Hours)","",""
"37896616702407","11674.41","-0.14","EURd","SWAP","PROCESSED","2023-08-26 21:24:00","","AAPL","Apple Inc (Extended Hours)","",""
"37896616702290","11674.55","-0.14","EURd","SWAP","PROCESSED","2023-08-26 21:24:00","","AAPL","Apple Inc (Extended Hours)","",""
"37896616702270","11674.69","-0.14","EURd","SWAP","PROCESSED","2023-08-26 21:24:00","","AAPL","Apple Inc (Extended Hours)","",""
"37896615653414","11674.83","-0.14","EURd","SWAP","PROCESSED","2023-08-26 21:23:59","","AAPL","Apple Inc (Extended Hours)","",""
"37895991753209","11674.97","-0.47","EURd","SWAP","PROCESSED","2023-08-26 21:14:04","","ETH/USD","Ethereum / USD","",""
"37895783082042","11675.44","-0.27","EURd","SWAP","PROCESSED","2023-08-26 21:10:45","","QCOM","QUALCOMM Inc (Extended Hours)","",""
"37895739039367","11675.71","-0.06","EURd","SWAP","PROCESSED","2023-08-26 21:10:03","","AMD","Advanced Micro Devices Inc (Extended Hours)","",""
"37895739039304","11675.77","-0.2","EURd","SWAP","PROCESSED","2023-08-26 21:10:03","","AMD","Advanced Micro Devices Inc (Extended Hours)","",""
"37895739039262","11675.97","-0.06","EURd","SWAP","PROCESSED","2023-08-26 21:10:03","","AMD","Advanced Micro Devices Inc (Extended Hours)","",""
"37895646758996","11676.03","-0.3","EURd","SWAP","PROCESSED","2023-08-26 21:08:35","","TSLA","Tesla Inc (Extended Hours)","",""
"37895639432440","11676.33","-0.3","EURd","SWAP","PROCESSED","2023-08-26 21:08:28","","TSLA","Tesla Inc (Extended Hours)","",""
"37895638383401","11676.63","-0.06","EURd","SWAP","PROCESSED","2023-08-26 21:08:27","","TSLA","Tesla Inc (Extended Hours)","",""
"37895637334469","11676.69","-0.3","EURd","SWAP","PROCESSED","2023-08-26 21:08:26","","TSLA","Tesla Inc (Extended Hours)","",""
"37895636285267","11676.99","-0.12","EURd","SWAP","PROCESSED","2023-08-26 21:08:25","","TSLA","Tesla Inc (Extended Hours)","",""
"37895635236266","11677.11","-0.3","EURd","SWAP","PROCESSED","2023-08-26 21:08:24","","TSLA","Tesla Inc (Extended Hours)","",""
"37895635236140","11677.41","-0.3","EURd","SWAP","PROCESSED","2023-08-26 21:08:24","","TSLA","Tesla Inc (Extended Hours)","",""
"37805835177495","11677.71","-0.14","EURd","SWAP","PROCESSED","2023-08-25 21:21:04","","AAPL","Apple Inc (Extended Hours)","",""
"37805835177375","11677.85","-0.14","EURd","SWAP","PROCESSED","2023-08-25 21:21:04","","AAPL","Apple Inc (Extended Hours)","",""
"37805835177342","11677.99","-0.14","EURd","SWAP","PROCESSED","2023-08-25 21:21:04","","AAPL","Apple Inc (Extended Hours)","",""
"37805834128523","11678.13","-0.14","EURd","SWAP","PROCESSED","2023-08-25 21:21:03","","AAPL","Apple Inc (Extended Hours)","",""
"37805290967697","11678.27","-0.27","EURd","SWAP","PROCESSED","2023-08-25 21:12:25","","QCOM","QUALCOMM Inc (Extended Hours)","",""
"37805185065646","11678.54","-0.3","EURd","SWAP","PROCESSED","2023-08-25 21:10:44","","TSLA","Tesla Inc (Extended Hours)","",""
"37805177722188","11678.84","-0.3","EURd","SWAP","PROCESSED","2023-08-25 21:10:37","","TSLA","Tesla Inc (Extended Hours)","",""
"37805176673202","11679.14","-0.06","EURd","SWAP","PROCESSED","2023-08-25 21:10:36","","TSLA","Tesla Inc (Extended Hours)","",""
"37805175624264","11679.2","-0.3","EURd","SWAP","PROCESSED","2023-08-25 21:10:35","","TSLA","Tesla Inc (Extended Hours)","",""
"37805174575048","11679.5","-0.12","EURd","SWAP","PROCESSED","2023-08-25 21:10:34","","TSLA","Tesla Inc (Extended Hours)","",""
"37805173526033","11679.62","-0.3","EURd","SWAP","PROCESSED","2023-08-25 21:10:33","","TSLA","Tesla Inc (Extended Hours)","",""
"37805172477329","11679.92","-0.3","EURd","SWAP","PROCESSED","2023-08-25 21:10:32","","TSLA","Tesla Inc (Extended Hours)","",""
"37805079163635","11680.22","-0.47","EURd","SWAP","PROCESSED","2023-08-25 21:09:03","","ETH/USD","Ethereum / USD","",""
"37804906141274","11680.69","-0.06","EURd","SWAP","PROCESSED","2023-08-25 21:06:18","","AMD","Advanced Micro Devices Inc (Extended Hours)","",""
"37804906141213","11680.75","-0.2","EURd","SWAP","PROCESSED","2023-08-25 21:06:18","","AMD","Advanced Micro Devices Inc (Extended Hours)","",""
"37804906141167","11680.95","-0.06","EURd","SWAP","PROCESSED","2023-08-25 21:06:18","","AMD","Advanced Micro Devices Inc (Extended Hours)","",""
"37715459471274","11681.01","-0.47","EURd","SWAP","PROCESSED","2023-08-24 21:24:35","","ETH/USD","Ethereum / USD","",""
"37715400743859","11681.48","-0.29","EURd","SWAP","PROCESSED","2023-08-24 21:23:39","","TSLA","Tesla Inc (Extended Hours)","",""
"37715392351548","11681.77","-0.29","EURd","SWAP","PROCESSED","2023-08-24 21:23:31","","TSLA","Tesla Inc (Extended Hours)","",""
"37715390253945","11682.06","-0.06","EURd","SWAP","PROCESSED","2023-08-24 21:23:29","","TSLA","Tesla Inc (Extended Hours)","",""
"37715389204978","11682.12","-0.29","EURd","SWAP","PROCESSED","2023-08-24 21:23:28","","TSLA","Tesla Inc (Extended Hours)","",""
"37715388155754","11682.41","-0.12","EURd","SWAP","PROCESSED","2023-08-24 21:23:27","","TSLA","Tesla Inc (Extended Hours)","",""
"37715387106797","11682.53","-0.29","EURd","SWAP","PROCESSED","2023-08-24 21:23:26","","TSLA","Tesla Inc (Extended Hours)","",""
"37715386058103","11682.82","-0.29","EURd","SWAP","PROCESSED","2023-08-24 21:23:25","","TSLA","Tesla Inc (Extended Hours)","",""
"37714734901326","11683.11","-0.27","EURd","SWAP","PROCESSED","2023-08-24 21:13:04","","QCOM","QUALCOMM Inc (Extended Hours)","",""
"37714578668031","11683.38","-0.13","EURd","SWAP","PROCESSED","2023-08-24 21:10:35","","AAPL","Apple Inc (Extended Hours)","",""
"37714578667922","11683.51","-0.13","EURd","SWAP","PROCESSED","2023-08-24 21:10:35","","AAPL","Apple Inc (Extended Hours)","",""
"37714578667894","11683.64","-0.13","EURd","SWAP","PROCESSED","2023-08-24 21:10:35","","AAPL","Apple Inc (Extended Hours)","",""
"37714577619071","11683.77","-0.13","EURd","SWAP","PROCESSED","2023-08-24 21:10:34","","AAPL","Apple Inc (Extended Hours)","",""
"37714131969192","11683.9","-0.06","EURd","SWAP","PROCESSED","2023-08-24 21:03:29","","AMD","Advanced Micro Devices Inc (Extended Hours)","",""
"37714131969149","11683.96","-0.2","EURd","SWAP","PROCESSED","2023-08-24 21:03:29","","AMD","Advanced Micro Devices Inc (Extended Hours)","",""
"37714131969118","11684.16","-0.06","EURd","SWAP","PROCESSED","2023-08-24 21:03:29","","AMD","Advanced Micro Devices Inc (Extended Hours)","",""
"37692101379992","11684.22","0.65","EURd","TRADE","PROCESSED","2023-08-24 15:13:19","00001344-0055-311e-0000-4c89000a959e_00001344-0055-311e-0000-000080220e94","AMD","Advanced Micro Devices Inc (Extended Hours)","",""
"37676361209672","11683.57","4.05","EURd","TRADE","PROCESSED","2023-08-24 11:03:08","00081081-0055-311e-0000-4c89000138ff_00081081-0055-311e-0000-000080220406","BABA","Alibaba Group Holding Limited (Extended Hours)","",""
"37627519589643","11679.52","-2.39","EURd","TRADE","PROCESSED","2023-08-23 22:06:49","00001344-0055-311e-0000-4c880015a689_00001344-0055-311e-0000-000080214c20","AMD","Advanced Micro Devices Inc (Extended Hours)","",""
"37627519589642","11681.91","18.31","EURd","TRADE","PROCESSED","2023-08-23 22:06:49","00001344-0055-311e-0000-4c880015a688_00001344-0055-311e-0000-000080214d0f","AMD","Advanced Micro Devices Inc (Extended Hours)","",""
"37624863550187","11663.6","-0.29","EURd","SWAP","PROCESSED","2023-08-23 21:24:36","","TSLA","Tesla Inc (Extended Hours)","",""
"37624862501101","11663.89","-0.06","EURd","SWAP","PROCESSED","2023-08-23 21:24:35","","TSLA","Tesla Inc (Extended Hours)","",""
"37624861452168","11663.95","-0.29","EURd","SWAP","PROCESSED","2023-08-23 21:24:34","","TSLA","Tesla Inc (Extended Hours)","",""
"37624858305353","11664.24","-0.12","EURd","SWAP","PROCESSED","2023-08-23 21:24:31","","TSLA","Tesla Inc (Extended Hours)","",""
"37624856207781","11664.36","-0.29","EURd","SWAP","PROCESSED","2023-08-23 21:24:29","","TSLA","Tesla Inc (Extended Hours)","",""
"37624856207635","11664.65","-0.29","EURd","SWAP","PROCESSED","2023-08-23 21:24:29","","TSLA","Tesla Inc (Extended Hours)","",""
"37623981690123","11664.94","-0.28","EURd","SWAP","PROCESSED","2023-08-23 21:10:35","","QCOM","QUALCOMM Inc (Extended Hours)","",""
"37623692291500","11665.22","-0.14","EURd","SWAP","PROCESSED","2023-08-23 21:05:59","","AAPL","Apple Inc (Extended Hours)","",""
"37623692291362","11665.36","-0.14","EURd","SWAP","PROCESSED","2023-08-23 21:05:59","","AAPL","Apple Inc (Extended Hours)","",""
"37623692291332","11665.5","-0.14","EURd","SWAP","PROCESSED","2023-08-23 21:05:59","","AAPL","Apple Inc (Extended Hours)","",""
"37623691242508","11665.64","-0.14","EURd","SWAP","PROCESSED","2023-08-23 21:05:58","","AAPL","Apple Inc (Extended Hours)","",""
"37623591623483","11665.78","-0.28","EURd","SWAP","PROCESSED","2023-08-23 21:04:23","","AMD","Advanced Micro Devices Inc (Extended Hours)","",""
"37623591623440","11666.06","-0.55","EURd","SWAP","PROCESSED","2023-08-23 21:04:23","","AMD","Advanced Micro Devices Inc (Extended Hours)","",""
"37533612272162","11666.61","-0.13","EURd","SWAP","PROCESSED","2023-08-22 21:14:12","","AAPL","Apple Inc (Extended Hours)","",""
"37533612272033","11666.74","-0.13","EURd","SWAP","PROCESSED","2023-08-22 21:14:12","","AAPL","Apple Inc (Extended Hours)","",""
"37533612272008","11666.87","-0.13","EURd","SWAP","PROCESSED","2023-08-22 21:14:12","","AAPL","Apple Inc (Extended Hours)","",""
"37533611223148","11667","-0.13","EURd","SWAP","PROCESSED","2023-08-22 21:14:11","","AAPL","Apple Inc (Extended Hours)","",""
"37533481196971","11667.13","-0.27","EURd","SWAP","PROCESSED","2023-08-22 21:12:07","","QCOM","QUALCOMM Inc (Extended Hours)","",""
"37533427714507","11667.4","-0.29","EURd","SWAP","PROCESSED","2023-08-22 21:11:16","","TSLA","Tesla Inc (Extended Hours)","",""
"37533425616854","11667.69","-0.06","EURd","SWAP","PROCESSED","2023-08-22 21:11:14","","TSLA","Tesla Inc (Extended Hours)","",""
"37533425616438","11667.75","-0.29","EURd","SWAP","PROCESSED","2023-08-22 21:11:14","","TSLA","Tesla Inc (Extended Hours)","",""
"37533423518411","11668.04","-0.12","EURd","SWAP","PROCESSED","2023-08-22 21:11:12","","TSLA","Tesla Inc (Extended Hours)","",""
"37533421420799","11668.16","-0.29","EURd","SWAP","PROCESSED","2023-08-22 21:11:10","","TSLA","Tesla Inc (Extended Hours)","",""
"37533421420663","11668.45","-0.29","EURd","SWAP","PROCESSED","2023-08-22 21:11:10","","TSLA","Tesla Inc (Extended Hours)","",""
"37532913922013","11668.74","-0.26","EURd","SWAP","PROCESSED","2023-08-22 21:03:06","","AMD","Advanced Micro Devices Inc (Extended Hours)","",""
"37532913921971","11669","-0.52","EURd","SWAP","PROCESSED","2023-08-22 21:03:06","","AMD","Advanced Micro Devices Inc (Extended Hours)","",""
"37443249141054","11669.52","-0.28","EURd","SWAP","PROCESSED","2023-08-21 21:17:55","","TSLA","Tesla Inc (Extended Hours)","",""
"37443248091927","11669.8","-0.06","EURd","SWAP","PROCESSED","2023-08-21 21:17:54","","TSLA","Tesla Inc (Extended Hours)","",""
"37443245994349","11669.86","-0.28","EURd","SWAP","PROCESSED","2023-08-21 21:17:52","","TSLA","Tesla Inc (Extended Hours)","",""
"37443243896383","11670.14","-0.12","EURd","SWAP","PROCESSED","2023-08-21 21:17:50","","TSLA","Tesla Inc (Extended Hours)","",""
"37443242847306","11670.26","-0.28","EURd","SWAP","PROCESSED","2023-08-21 21:17:49","","TSLA","Tesla Inc (Extended Hours)","",""
"37443242847164","11670.54","-0.28","EURd","SWAP","PROCESSED","2023-08-21 21:17:49","","TSLA","Tesla Inc (Extended Hours)","",""
"37443111773062","11670.82","-0.13","EURd","SWAP","PROCESSED","2023-08-21 21:15:44","","AAPL","Apple Inc (Extended Hours)","",""
"37443111772936","11670.95","-0.13","EURd","SWAP","PROCESSED","2023-08-21 21:15:44","","AAPL","Apple Inc (Extended Hours)","",""
"37443111772903","11671.08","-0.13","EURd","SWAP","PROCESSED","2023-08-21 21:15:44","","AAPL","Apple Inc (Extended Hours)","",""
"37443110724008","11671.21","-0.13","EURd","SWAP","PROCESSED","2023-08-21 21:15:43","","AAPL","Apple Inc (Extended Hours)","",""
"37442765735429","11671.34","-0.27","EURd","SWAP","PROCESSED","2023-08-21 21:10:14","","AMD","Advanced Micro Devices Inc (Extended Hours)","",""
"37442765735398","11671.61","-0.52","EURd","SWAP","PROCESSED","2023-08-21 21:10:14","","AMD","Advanced Micro Devices Inc (Extended Hours)","",""
"37442465855565","11672.13","-0.27","EURd","SWAP","PROCESSED","2023-08-21 21:05:28","","QCOM","QUALCOMM Inc (Extended Hours)","",""
"37353129264253","11672.4","-0.13","EURd","SWAP","PROCESSED","2023-08-20 21:25:30","","AAPL","Apple Inc (Extended Hours)","",""
"37353129264107","11672.53","-0.13","EURd","SWAP","PROCESSED","2023-08-20 21:25:30","","AAPL","Apple Inc (Extended Hours)","",""
"37353129264084","11672.66","-0.13","EURd","SWAP","PROCESSED","2023-08-20 21:25:30","","AAPL","Apple Inc (Extended Hours)","",""
"37353128215169","11672.79","-0.13","EURd","SWAP","PROCESSED","2023-08-20 21:25:29","","AAPL","Apple Inc (Extended Hours)","",""
"37352625956176","11672.92","-0.26","EURd","SWAP","PROCESSED","2023-08-20 21:17:30","","AMD","Advanced Micro Devices Inc (Extended Hours)","",""
"37352625956139","11673.18","-0.51","EURd","SWAP","PROCESSED","2023-08-20 21:17:30","","AMD","Advanced Micro Devices Inc (Extended Hours)","",""
"37352033505633","11673.69","-0.27","EURd","SWAP","PROCESSED","2023-08-20 21:08:05","","QCOM","QUALCOMM Inc (Extended Hours)","",""
"37351735710258","11673.96","-0.27","EURd","SWAP","PROCESSED","2023-08-20 21:03:21","","TSLA","Tesla Inc (Extended Hours)","",""
"37351733612427","11674.23","-0.06","EURd","SWAP","PROCESSED","2023-08-20 21:03:19","","TSLA","Tesla Inc (Extended Hours)","",""
"37351733612037","11674.29","-0.27","EURd","SWAP","PROCESSED","2023-08-20 21:03:19","","TSLA","Tesla Inc (Extended Hours)","",""
"37351731514070","11674.56","-0.11","EURd","SWAP","PROCESSED","2023-08-20 21:03:17","","TSLA","Tesla Inc (Extended Hours)","",""
"37351730464979","11674.67","-0.27","EURd","SWAP","PROCESSED","2023-08-20 21:03:16","","TSLA","Tesla Inc (Extended Hours)","",""
"37351730464844","11674.94","-0.27","EURd","SWAP","PROCESSED","2023-08-20 21:03:16","","TSLA","Tesla Inc (Extended Hours)","",""
"37262182088340","11675.21","-0.27","EURd","SWAP","PROCESSED","2023-08-19 21:19:56","","QCOM","QUALCOMM Inc (Extended Hours)","",""
"37261620040934","11675.48","-0.26","EURd","SWAP","PROCESSED","2023-08-19 21:11:00","","AMD","Advanced Micro Devices Inc (Extended Hours)","",""
"37261620040911","11675.74","-0.51","EURd","SWAP","PROCESSED","2023-08-19 21:11:00","","AMD","Advanced Micro Devices Inc (Extended Hours)","",""
"37261261427854","11676.25","-0.13","EURd","SWAP","PROCESSED","2023-08-19 21:05:18","","AAPL","Apple Inc (Extended Hours)","",""
"37261261427735","11676.38","-0.13","EURd","SWAP","PROCESSED","2023-08-19 21:05:18","","AAPL","Apple Inc (Extended Hours)","",""
"37261261427701","11676.51","-0.13","EURd","SWAP","PROCESSED","2023-08-19 21:05:18","","AAPL","Apple Inc (Extended Hours)","",""
"37261260378809","11676.64","-0.13","EURd","SWAP","PROCESSED","2023-08-19 21:05:17","","AAPL","Apple Inc (Extended Hours)","",""
"37261199568221","11676.77","-0.27","EURd","SWAP","PROCESSED","2023-08-19 21:04:19","","TSLA","Tesla Inc (Extended Hours)","",""
"37261197470163","11677.04","-0.06","EURd","SWAP","PROCESSED","2023-08-19 21:04:17","","TSLA","Tesla Inc (Extended Hours)","",""
"37261195372279","11677.1","-0.27","EURd","SWAP","PROCESSED","2023-08-19 21:04:15","","TSLA","Tesla Inc (Extended Hours)","",""
"37261192224949","11677.37","-0.11","EURd","SWAP","PROCESSED","2023-08-19 21:04:12","","TSLA","Tesla Inc (Extended Hours)","",""
"37261186980027","11677.48","-0.27","EURd","SWAP","PROCESSED","2023-08-19 21:04:07","","TSLA","Tesla Inc (Extended Hours)","",""
"37261184882168","11677.75","-0.27","EURd","SWAP","PROCESSED","2023-08-19 21:04:05","","TSLA","Tesla Inc (Extended Hours)","",""
"37171208670997","11678.02","-0.26","EURd","SWAP","PROCESSED","2023-08-18 21:13:57","","AMD","Advanced Micro Devices Inc (Extended Hours)","",""
"37171208670925","11678.28","-0.51","EURd","SWAP","PROCESSED","2023-08-18 21:13:57","","AMD","Advanced Micro Devices Inc (Extended Hours)","",""
"37170854261112","11678.79","-0.13","EURd","SWAP","PROCESSED","2023-08-18 21:08:19","","AAPL","Apple Inc (Extended Hours)","",""
"37170854261015","11678.92","-0.13","EURd","SWAP","PROCESSED","2023-08-18 21:08:19","","AAPL","Apple Inc (Extended Hours)","",""
"37170854260981","11679.05","-0.13","EURd","SWAP","PROCESSED","2023-08-18 21:08:19","","AAPL","Apple Inc (Extended Hours)","",""
"37170853212058","11679.18","-0.13","EURd","SWAP","PROCESSED","2023-08-18 21:08:18","","AAPL","Apple Inc (Extended Hours)","",""
"37170823841185","11679.31","-0.27","EURd","SWAP","PROCESSED","2023-08-18 21:07:50","","TSLA","Tesla Inc (Extended Hours)","",""
"37170821743349","11679.58","-0.06","EURd","SWAP","PROCESSED","2023-08-18 21:07:48","","TSLA","Tesla Inc (Extended Hours)","",""
"37170820694397","11679.64","-0.27","EURd","SWAP","PROCESSED","2023-08-18 21:07:47","","TSLA","Tesla Inc (Extended Hours)","",""
"37170818612710","11679.91","-0.11","EURd","SWAP","PROCESSED","2023-08-18 21:07:45","","TSLA","Tesla Inc (Extended Hours)","",""
"37170817563665","11680.02","-0.27","EURd","SWAP","PROCESSED","2023-08-18 21:07:44","","TSLA","Tesla Inc (Extended Hours)","",""
"37170817563540","11680.29","-0.27","EURd","SWAP","PROCESSED","2023-08-18 21:07:44","","TSLA","Tesla Inc (Extended Hours)","",""
"37170537593800","11680.56","-0.27","EURd","SWAP","PROCESSED","2023-08-18 21:03:17","","QCOM","QUALCOMM Inc (Extended Hours)","",""
"37080935713031","11680.83","-0.26","EURd","SWAP","PROCESSED","2023-08-17 21:19:06","","AMD","Advanced Micro Devices Inc (Extended Hours)","",""
"37080935713003","11681.09","-0.51","EURd","SWAP","PROCESSED","2023-08-17 21:19:06","","AMD","Advanced Micro Devices Inc (Extended Hours)","",""
"37080450225770","11681.6","-0.27","EURd","SWAP","PROCESSED","2023-08-17 21:11:23","","TSLA","Tesla Inc (Extended Hours)","",""
"37080447079261","11681.87","-0.06","EURd","SWAP","PROCESSED","2023-08-17 21:11:20","","TSLA","Tesla Inc (Extended Hours)","",""
"37080446030238","11681.93","-0.27","EURd","SWAP","PROCESSED","2023-08-17 21:11:19","","TSLA","Tesla Inc (Extended Hours)","",""
"37080443932121","11682.2","-0.11","EURd","SWAP","PROCESSED","2023-08-17 21:11:17","","TSLA","Tesla Inc (Extended Hours)","",""
"37080442883008","11682.31","-0.27","EURd","SWAP","PROCESSED","2023-08-17 21:11:16","","TSLA","Tesla Inc (Extended Hours)","",""
"37080442882869","11682.58","-0.27","EURd","SWAP","PROCESSED","2023-08-17 21:11:16","","TSLA","Tesla Inc (Extended Hours)","",""
"37080296087277","11682.85","-0.27","EURd","SWAP","PROCESSED","2023-08-17 21:08:56","","QCOM","QUALCOMM Inc (Extended Hours)","",""
"37079878750661","11683.12","-0.13","EURd","SWAP","PROCESSED","2023-08-17 21:02:18","","AAPL","Apple Inc (Extended Hours)","",""
"37079878750538","11683.25","-0.13","EURd","SWAP","PROCESSED","2023-08-17 21:02:18","","AAPL","Apple Inc (Extended Hours)","",""
"37079878750526","11683.38","-0.13","EURd","SWAP","PROCESSED","2023-08-17 21:02:18","","AAPL","Apple Inc (Extended Hours)","",""
"37079877701640","11683.51","-0.13","EURd","SWAP","PROCESSED","2023-08-17 21:02:17","","AAPL","Apple Inc (Extended Hours)","",""
"36990369156754","11683.64","-0.27","EURd","SWAP","PROCESSED","2023-08-16 21:19:35","","QCOM","QUALCOMM Inc (Extended Hours)","",""
"36989840681062","11683.91","-0.28","EURd","SWAP","PROCESSED","2023-08-16 21:11:11","","TSLA","Tesla Inc (Extended Hours)","",""
"36989838583039","11684.19","-0.06","EURd","SWAP","PROCESSED","2023-08-16 21:11:09","","TSLA","Tesla Inc (Extended Hours)","",""
"36989836485487","11684.25","-0.28","EURd","SWAP","PROCESSED","2023-08-16 21:11:07","","TSLA","Tesla Inc (Extended Hours)","",""
"36989834387281","11684.53","-0.11","EURd","SWAP","PROCESSED","2023-08-16 21:11:05","","TSLA","Tesla Inc (Extended Hours)","",""
"36989832289624","11684.64","-0.28","EURd","SWAP","PROCESSED","2023-08-16 21:11:03","","TSLA","Tesla Inc (Extended Hours)","",""
"36989832289489","11684.92","-0.28","EURd","SWAP","PROCESSED","2023-08-16 21:11:03","","TSLA","Tesla Inc (Extended Hours)","",""
"36989399222547","11685.2","-0.13","EURd","SWAP","PROCESSED","2023-08-16 21:04:10","","AAPL","Apple Inc (Extended Hours)","",""
"36989398173858","11685.33","-0.13","EURd","SWAP","PROCESSED","2023-08-16 21:04:09","","AAPL","Apple Inc (Extended Hours)","",""
"36989398173838","11685.46","-0.13","EURd","SWAP","PROCESSED","2023-08-16 21:04:09","","AAPL","Apple Inc (Extended Hours)","",""
"36989398173518","11685.59","-0.13","EURd","SWAP","PROCESSED","2023-08-16 21:04:09","","AAPL","Apple Inc (Extended Hours)","",""
"36989368818229","11685.72","-0.27","EURd","SWAP","PROCESSED","2023-08-16 21:03:41","","AMD","Advanced Micro Devices Inc (Extended Hours)","",""
"36989368818198","11685.99","-0.52","EURd","SWAP","PROCESSED","2023-08-16 21:03:41","","AMD","Advanced Micro Devices Inc (Extended Hours)","",""
"36982728189141","11686.51","-1.71","EURd","TRADE","PROCESSED","2023-08-16 19:18:08","00001344-0055-311e-0000-4c8100177026_00001344-0055-311e-0000-000080215854","AMD","Advanced Micro Devices Inc (Extended Hours)","",""
"36899431402348","11688.22","-0.28","EURd","SWAP","PROCESSED","2023-08-15 21:14:10","","QCOM","QUALCOMM Inc (Extended Hours)","",""
"36899354858845","11688.5","-0.28","EURd","SWAP","PROCESSED","2023-08-15 21:12:57","","AMD","Advanced Micro Devices Inc (Extended Hours)","",""
"36899354858815","11688.78","-0.54","EURd","SWAP","PROCESSED","2023-08-15 21:12:57","","AMD","Advanced Micro Devices Inc (Extended Hours)","",""
"36899250007612","11689.32","-0.13","EURd","SWAP","PROCESSED","2023-08-15 21:11:17","","AAPL","Apple Inc (Extended Hours)","",""
"36899250007490","11689.45","-0.13","EURd","SWAP","PROCESSED","2023-08-15 21:11:17","","AAPL","Apple Inc (Extended Hours)","",""
"36899250007447","11689.58","-0.13","EURd","SWAP","PROCESSED","2023-08-15 21:11:17","","AAPL","Apple Inc (Extended Hours)","",""
"36899248958525","11689.71","-0.13","EURd","SWAP","PROCESSED","2023-08-15 21:11:16","","AAPL","Apple Inc (Extended Hours)","",""
"36898985758606","11689.84","-0.28","EURd","SWAP","PROCESSED","2023-08-15 21:07:05","","TSLA","Tesla Inc (Extended Hours)","",""
"36898982611523","11690.12","-0.06","EURd","SWAP","PROCESSED","2023-08-15 21:07:02","","TSLA","Tesla Inc (Extended Hours)","",""
"36898981562433","11690.18","-0.28","EURd","SWAP","PROCESSED","2023-08-15 21:07:01","","TSLA","Tesla Inc (Extended Hours)","",""
"36898978415531","11690.46","-0.12","EURd","SWAP","PROCESSED","2023-08-15 21:06:58","","TSLA","Tesla Inc (Extended Hours)","",""
"36898977366408","11690.58","-0.28","EURd","SWAP","PROCESSED","2023-08-15 21:06:57","","TSLA","Tesla Inc (Extended Hours)","",""
"36898976317648","11690.86","-0.28","EURd","SWAP","PROCESSED","2023-08-15 21:06:56","","TSLA","Tesla Inc (Extended Hours)","",""
"36809701609253","11691.14","-0.06","EURd","SWAP","PROCESSED","2023-08-14 21:27:57","","TSLA","Tesla Inc (Extended Hours)","",""
"36809700560031","11691.2","-0.29","EURd","SWAP","PROCESSED","2023-08-14 21:27:56","","TSLA","Tesla Inc (Extended Hours)","",""
"36809697413059","11691.49","-0.12","EURd","SWAP","PROCESSED","2023-08-14 21:27:53","","TSLA","Tesla Inc (Extended Hours)","",""
"36809695315393","11691.61","-0.29","EURd","SWAP","PROCESSED","2023-08-14 21:27:51","","TSLA","Tesla Inc (Extended Hours)","",""
"36809695315161","11691.9","-0.29","EURd","SWAP","PROCESSED","2023-08-14 21:27:51","","TSLA","Tesla Inc (Extended Hours)","",""
"36809288479935","11692.19","-0.28","EURd","SWAP","PROCESSED","2023-08-14 21:21:23","","QCOM","QUALCOMM Inc (Extended Hours)","",""
"36809086102646","11692.47","-0.14","EURd","SWAP","PROCESSED","2023-08-14 21:18:10","","AAPL","Apple Inc (Extended Hours)","",""
"36809085053907","11692.61","-0.14","EURd","SWAP","PROCESSED","2023-08-14 21:18:09","","AAPL","Apple Inc (Extended Hours)","",""
"36809085053878","11692.75","-0.14","EURd","SWAP","PROCESSED","2023-08-14 21:18:09","","AAPL","Apple Inc (Extended Hours)","",""
"36809084004980","11692.89","-0.14","EURd","SWAP","PROCESSED","2023-08-14 21:18:08","","AAPL","Apple Inc (Extended Hours)","",""
"36809001166915","11693.03","-0.28","EURd","SWAP","PROCESSED","2023-08-14 21:16:49","","AMD","Advanced Micro Devices Inc (Extended Hours)","",""
"36809001166880","11693.31","-0.54","EURd","SWAP","PROCESSED","2023-08-14 21:16:49","","AMD","Advanced Micro Devices Inc (Extended Hours)","",""
"36791735305924","11693.85","14.63","EURd","TRADE","PROCESSED","2023-08-14 16:42:23","00396101-0055-311e-0000-4c7f000fead8_00396101-0055-311e-0000-00008023af14","NVDA","NVIDIA Corp (Extended Hours)","",""
"36718722971118","11679.22","-0.3","EURd","SWAP","PROCESSED","2023-08-13 21:21:53","","NVDA","NVIDIA Corp (Extended Hours)","",""
"36718380085548","11679.52","-0.13","EURd","SWAP","PROCESSED","2023-08-13 21:16:26","","AAPL","Apple Inc (Extended Hours)","",""
"36718379036829","11679.65","-0.13","EURd","SWAP","PROCESSED","2023-08-13 21:16:25","","AAPL","Apple Inc (Extended Hours)","",""
"36718379036792","11679.78","-0.13","EURd","SWAP","PROCESSED","2023-08-13 21:16:25","","AAPL","Apple Inc (Extended Hours)","",""
"36718379036485","11679.91","-0.13","EURd","SWAP","PROCESSED","2023-08-13 21:16:25","","AAPL","Apple Inc (Extended Hours)","",""
"36718183999521","11680.04","-0.26","EURd","SWAP","PROCESSED","2023-08-13 21:13:19","","AMD","Advanced Micro Devices Inc (Extended Hours)","",""
"36718183999482","11680.3","-0.52","EURd","SWAP","PROCESSED","2023-08-13 21:13:19","","AMD","Advanced Micro Devices Inc (Extended Hours)","",""
"36718025662593","11680.82","-0.06","EURd","SWAP","PROCESSED","2023-08-13 21:10:48","","TSLA","Tesla Inc (Extended Hours)","",""
"36718022515773","11680.88","-0.29","EURd","SWAP","PROCESSED","2023-08-13 21:10:45","","TSLA","Tesla Inc (Extended Hours)","",""
"36718019368700","11681.17","-0.12","EURd","SWAP","PROCESSED","2023-08-13 21:10:42","","TSLA","Tesla Inc (Extended Hours)","",""
"36718018319481","11681.29","-0.29","EURd","SWAP","PROCESSED","2023-08-13 21:10:41","","TSLA","Tesla Inc (Extended Hours)","",""
"36718017270381","11681.58","-0.29","EURd","SWAP","PROCESSED","2023-08-13 21:10:40","","TSLA","Tesla Inc (Extended Hours)","",""
"36717576869648","11681.87","-0.28","EURd","SWAP","PROCESSED","2023-08-13 21:03:40","","QCOM","QUALCOMM Inc (Extended Hours)","",""
"36628268597432","11682.15","-0.26","EURd","SWAP","PROCESSED","2023-08-12 21:24:09","","AMD","Advanced Micro Devices Inc (Extended Hours)","",""
"36628268597396","11682.41","-0.52","EURd","SWAP","PROCESSED","2023-08-12 21:24:09","","AMD","Advanced Micro Devices Inc (Extended Hours)","",""
"36628176331138","11682.93","-0.28","EURd","SWAP","PROCESSED","2023-08-12 21:22:41","","QCOM","QUALCOMM Inc (Extended Hours)","",""
"36627918380331","11683.21","-0.3","EURd","SWAP","PROCESSED","2023-08-12 21:18:35","","NVDA","NVIDIA Corp (Extended Hours)","",""
"36627761089893","11683.51","-0.06","EURd","SWAP","PROCESSED","2023-08-12 21:16:05","","TSLA","Tesla Inc (Extended Hours)","",""
"36627755844806","11683.57","-0.29","EURd","SWAP","PROCESSED","2023-08-12 21:16:00","","TSLA","Tesla Inc (Extended Hours)","",""
"36627751664665","11683.86","-0.12","EURd","SWAP","PROCESSED","2023-08-12 21:15:56","","TSLA","Tesla Inc (Extended Hours)","",""
"36627749566622","11683.98","-0.29","EURd","SWAP","PROCESSED","2023-08-12 21:15:54","","TSLA","Tesla Inc (Extended Hours)","",""
"36627748517748","11684.27","-0.29","EURd","SWAP","PROCESSED","2023-08-12 21:15:53","","TSLA","Tesla Inc (Extended Hours)","",""
"36627372078226","11684.56","-0.13","EURd","SWAP","PROCESSED","2023-08-12 21:09:54","","AAPL","Apple Inc (Extended Hours)","",""
"36627369980639","11684.69","-0.13","EURd","SWAP","PROCESSED","2023-08-12 21:09:52","","AAPL","Apple Inc (Extended Hours)","",""
"36627369980603","11684.82","-0.13","EURd","SWAP","PROCESSED","2023-08-12 21:09:52","","AAPL","Apple Inc (Extended Hours)","",""
"36627368931491","11684.95","-0.13","EURd","SWAP","PROCESSED","2023-08-12 21:09:51","","AAPL","Apple Inc (Extended Hours)","",""
"36537652763531","11685.08","-0.28","EURd","SWAP","PROCESSED","2023-08-11 21:23:51","","QCOM","QUALCOMM Inc (Extended Hours)","",""
"36537557350922","11685.36","-0.26","EURd","SWAP","PROCESSED","2023-08-11 21:22:20","","AMD","Advanced Micro Devices Inc (Extended Hours)","",""
"36537557350889","11685.62","-0.52","EURd","SWAP","PROCESSED","2023-08-11 21:22:20","","AMD","Advanced Micro Devices Inc (Extended Hours)","",""
"36537527977874","11686.14","-0.3","EURd","SWAP","PROCESSED","2023-08-11 21:21:52","","NVDA","NVIDIA Corp (Extended Hours)","",""
"36537171466102","11686.44","-0.06","EURd","SWAP","PROCESSED","2023-08-11 21:16:12","","TSLA","Tesla Inc (Extended Hours)","",""
"36537169368001","11686.5","-0.29","EURd","SWAP","PROCESSED","2023-08-11 21:16:10","","TSLA","Tesla Inc (Extended Hours)","",""
"36537165172274","11686.79","-0.12","EURd","SWAP","PROCESSED","2023-08-11 21:16:06","","TSLA","Tesla Inc (Extended Hours)","",""
"36537164123065","11686.91","-0.29","EURd","SWAP","PROCESSED","2023-08-11 21:16:05","","TSLA","Tesla Inc (Extended Hours)","",""
"36537163074214","11687.2","-0.29","EURd","SWAP","PROCESSED","2023-08-11 21:16:04","","TSLA","Tesla Inc (Extended Hours)","",""
"36536711138406","11687.49","-0.13","EURd","SWAP","PROCESSED","2023-08-11 21:08:53","","AAPL","Apple Inc (Extended Hours)","",""
"36536711138256","11687.62","-0.13","EURd","SWAP","PROCESSED","2023-08-11 21:08:53","","AAPL","Apple Inc (Extended Hours)","",""
"36536711138209","11687.75","-0.13","EURd","SWAP","PROCESSED","2023-08-11 21:08:53","","AAPL","Apple Inc (Extended Hours)","",""
"36536709040337","11687.88","-0.13","EURd","SWAP","PROCESSED","2023-08-11 21:08:51","","AAPL","Apple Inc (Extended Hours)","",""
"36447169046681","11688.01","-0.3","EURd","SWAP","PROCESSED","2023-08-10 21:25:39","","TSLA","Tesla Inc (Extended Hours)","",""
"36447164850144","11688.31","-0.12","EURd","SWAP","PROCESSED","2023-08-10 21:25:35","","TSLA","Tesla Inc (Extended Hours)","",""
"36447163800912","11688.43","-0.3","EURd","SWAP","PROCESSED","2023-08-10 21:25:34","","TSLA","Tesla Inc (Extended Hours)","",""
"36447160654131","11688.73","-0.3","EURd","SWAP","PROCESSED","2023-08-10 21:25:31","","TSLA","Tesla Inc (Extended Hours)","",""
"36446880682284","11689.03","-0.26","EURd","SWAP","PROCESSED","2023-08-10 21:21:04","","AMD","Advanced Micro Devices Inc (Extended Hours)","",""
"36446880682250","11689.29","-0.53","EURd","SWAP","PROCESSED","2023-08-10 21:21:04","","AMD","Advanced Micro Devices Inc (Extended Hours)","",""
"36446253632134","11689.82","-0.13","EURd","SWAP","PROCESSED","2023-08-10 21:11:06","","AAPL","Apple Inc (Extended Hours)","",""
"36446253631955","11689.95","-0.13","EURd","SWAP","PROCESSED","2023-08-10 21:11:06","","AAPL","Apple Inc (Extended Hours)","",""
"36446253631915","11690.08","-0.13","EURd","SWAP","PROCESSED","2023-08-10 21:11:06","","AAPL","Apple Inc (Extended Hours)","",""
"36446252583043","11690.21","-0.13","EURd","SWAP","PROCESSED","2023-08-10 21:11:05","","AAPL","Apple Inc (Extended Hours)","",""
"36421896259773","11690.34","3","EURd","TRADE","PROCESSED","2023-08-10 14:43:57","0001304e-0015-549e-0000-4c7b00069b97_0001304e-0015-549e-0000-000080230086","SANe","Banco Santander","",""
"36356429478699","11687.34","-0.14","EURd","SWAP","PROCESSED","2023-08-09 21:23:23","","AAPL","Apple Inc (Extended Hours)","",""
"36356429478510","11687.48","-0.14","EURd","SWAP","PROCESSED","2023-08-09 21:23:23","","AAPL","Apple Inc (Extended Hours)","",""
"36356429478481","11687.62","-0.14","EURd","SWAP","PROCESSED","2023-08-09 21:23:23","","AAPL","Apple Inc (Extended Hours)","",""
"36356428429576","11687.76","-0.14","EURd","SWAP","PROCESSED","2023-08-09 21:23:22","","AAPL","Apple Inc (Extended Hours)","",""
"36356046748839","11687.9","-0.12","EURd","SWAP","PROCESSED","2023-08-09 21:17:18","","TSLA","Tesla Inc (Extended Hours)","",""
"36356044650687","11688.02","-0.29","EURd","SWAP","PROCESSED","2023-08-09 21:17:16","","TSLA","Tesla Inc (Extended Hours)","",""
"36356042552817","11688.31","-0.29","EURd","SWAP","PROCESSED","2023-08-09 21:17:14","","TSLA","Tesla Inc (Extended Hours)","",""
"36355935590898","11688.6","-0.22","EURd","SWAP","PROCESSED","2023-08-09 21:15:32","","SANe","Banco Santander","",""
"36313857280715","11688.82","18","EURd","TRADE","PROCESSED","2023-08-09 10:06:43","00082581-0015-549e-0000-4c7a00036522_00082581-0015-549e-0000-000080230083","BBVA","BBVA","",""
"36313857280714","11670.82","-10","EURd","TRADE","PROCESSED","2023-08-09 10:06:43","00082581-0015-549e-0000-4c7a00036521_00082581-0015-549e-0000-000080230075","BBVA","BBVA","",""
"36313791220277","11680.82","9.56","EURd","TRADE","PROCESSED","2023-08-09 10:05:40","00001344-0055-311e-0000-4c7a0001630d_00001344-0055-311e-0000-000080214814","AMD","Advanced Micro Devices Inc (Extended Hours)","",""
"36313788074539","11671.26","3.1","EURd","TRADE","PROCESSED","2023-08-09 10:05:37","00396101-0055-311e-0000-4c7a00016306_00396101-0055-311e-0000-00008023a7a4","NVDA","NVIDIA Corp (Extended Hours)","",""
"36266081014647","11668.16","-0.13","EURd","SWAP","PROCESSED","2023-08-08 21:27:20","","TSLA","Tesla Inc (Extended Hours)","",""
"36266078916561","11668.29","-0.3","EURd","SWAP","PROCESSED","2023-08-08 21:27:18","","TSLA","Tesla Inc (Extended Hours)","",""
"36266078916279","11668.59","-0.3","EURd","SWAP","PROCESSED","2023-08-08 21:27:18","","TSLA","Tesla Inc (Extended Hours)","",""
"36265527371334","11668.89","-0.27","EURd","SWAP","PROCESSED","2023-08-08 21:18:32","","AMD","Advanced Micro Devices Inc (Extended Hours)","",""
"36265063891157","11669.16","-0.14","EURd","SWAP","PROCESSED","2023-08-08 21:11:10","","AAPL","Apple Inc (Extended Hours)","",""
"36265063907316","11669.3","-0.14","EURd","SWAP","PROCESSED","2023-08-08 21:11:10","","AAPL","Apple Inc (Extended Hours)","",""
"36265063907265","11669.44","-0.14","EURd","SWAP","PROCESSED","2023-08-08 21:11:10","","AAPL","Apple Inc (Extended Hours)","",""
"36265062858337","11669.58","-0.14","EURd","SWAP","PROCESSED","2023-08-08 21:11:09","","AAPL","Apple Inc (Extended Hours)","",""
"36264830068788","11669.72","-0.43","EURd","SWAP","PROCESSED","2023-08-08 21:07:27","","NVDA","NVIDIA Corp (Extended Hours)","",""
"36264727304125","11670.15","-0.22","EURd","SWAP","PROCESSED","2023-08-08 21:05:49","","SANe","Banco Santander","",""
"36264528078540","11670.37","-0.29","EURd","SWAP","PROCESSED","2023-08-08 21:02:39","","BBVA","BBVA","",""
"36264528078512","11670.66","-0.29","EURd","SWAP","PROCESSED","2023-08-08 21:02:39","","BBVA","BBVA","",""
"36256051391864","11670.95","9.54","EURd","TRADE","PROCESSED","2023-08-08 18:47:55","0015421d-0055-311e-0000-4c7900062398_0015421d-0055-311e-0000-000080e08814","ETH/USD","Ethereum / USD","",""
"36256041954663","11661.41","24.7","EURd","TRADE","PROCESSED","2023-08-08 18:47:46","000940dd-0055-311e-0000-4c79000d6672_000940dd-0055-311e-0000-0000819f8f9c","BTC/USD","Bitcoin / USD","",""
"36220856978893","11636.71","1.56","EURd","TRADE","PROCESSED","2023-08-08 09:28:31","000940dd-0055-311e-0000-4c7900053257_000940dd-0055-311e-0000-0000819f991a","BTC/USD","Bitcoin / USD","",""
"36175892994773","11635.15","-0.23","EURd","SWAP","PROCESSED","2023-08-07 21:33:50","","SANe","Banco Santander","",""
"36175861542969","11635.38","-0.52","EURd","SWAP","PROCESSED","2023-08-07 21:33:20","","ETH/USD","Ethereum / USD","",""
"36175802818273","11635.9","-0.13","EURd","SWAP","PROCESSED","2023-08-07 21:32:24","","TSLA","Tesla Inc (Extended Hours)","",""
"36175799671059","11636.03","-0.31","EURd","SWAP","PROCESSED","2023-08-07 21:32:21","","TSLA","Tesla Inc (Extended Hours)","",""
"36175798622160","11636.34","-0.31","EURd","SWAP","PROCESSED","2023-08-07 21:32:20","","TSLA","Tesla Inc (Extended Hours)","",""
"36175232385914","11636.65","-0.29","EURd","SWAP","PROCESSED","2023-08-07 21:23:20","","BBVA","BBVA","",""
"36174362080922","11636.94","-0.82","EURd","SWAP","PROCESSED","2023-08-07 21:09:30","","BTC/USD","Bitcoin / USD","",""
"36174361032096","11637.76","-0.82","EURd","SWAP","PROCESSED","2023-08-07 21:09:29","","BTC/USD","Bitcoin / USD","",""
"36174136633681","11638.58","-0.14","EURd","SWAP","PROCESSED","2023-08-07 21:05:55","","AAPL","Apple Inc (Extended Hours)","",""
"36174135584840","11638.72","-0.14","EURd","SWAP","PROCESSED","2023-08-07 21:05:54","","AAPL","Apple Inc (Extended Hours)","",""
"36174135584799","11638.86","-0.14","EURd","SWAP","PROCESSED","2023-08-07 21:05:54","","AAPL","Apple Inc (Extended Hours)","",""
"36174134535837","11639","-0.14","EURd","SWAP","PROCESSED","2023-08-07 21:05:53","","AAPL","Apple Inc (Extended Hours)","",""
"36172643466401","11639.14","2.23","EURd","TRADE","PROCESSED","2023-08-07 20:42:11","00001344-0055-311e-0000-4c780018073d_00001344-0055-311e-0000-0000802144ab","AMD","Advanced Micro Devices Inc (Extended Hours)","",""
"36155312596515","11636.91","5.27","EURd","TRADE","PROCESSED","2023-08-07 16:06:43","0041940c-0055-311e-0000-4c78000e3c07_0041940c-0055-311e-0000-0000802017ec","PYPL","PayPal Holdings (Extended Hours)","",""
"36084997178784","11631.64","-0.14","EURd","SWAP","PROCESSED","2023-08-06 21:29:05","","AAPL","Apple Inc (Extended Hours)","",""
"36084997178493","11631.78","-0.14","EURd","SWAP","PROCESSED","2023-08-06 21:29:04","","AAPL","Apple Inc (Extended Hours)","",""
"36084996129882","11631.92","-0.14","EURd","SWAP","PROCESSED","2023-08-06 21:29:04","","AAPL","Apple Inc (Extended Hours)","",""
"36084995080873","11632.06","-0.14","EURd","SWAP","PROCESSED","2023-08-06 21:29:03","","AAPL","Apple Inc (Extended Hours)","",""
"36084955235405","11632.2","-0.82","EURd","SWAP","PROCESSED","2023-08-06 21:28:25","","BTC/USD","Bitcoin / USD","",""
"36084954186595","11633.02","-0.82","EURd","SWAP","PROCESSED","2023-08-06 21:28:24","","BTC/USD","Bitcoin / USD","",""
"36084822079921","11633.84","-0.23","EURd","SWAP","PROCESSED","2023-08-06 21:26:18","","SANe","Banco Santander","",""
"36084448772613","11634.07","-0.52","EURd","SWAP","PROCESSED","2023-08-06 21:20:22","","ETH/USD","Ethereum / USD","",""
"36083754624869","11634.59","-0.31","EURd","SWAP","PROCESSED","2023-08-06 21:09:20","","TSLA","Tesla Inc (Extended Hours)","",""
"36083753575721","11634.9","-0.31","EURd","SWAP","PROCESSED","2023-08-06 21:09:19","","TSLA","Tesla Inc (Extended Hours)","",""
"36083564828712","11635.21","-0.29","EURd","SWAP","PROCESSED","2023-08-06 21:06:19","","BBVA","BBVA","",""
"36083474650629","11635.5","-0.3","EURd","SWAP","PROCESSED","2023-08-06 21:04:53","","PYPL","PayPal Holdings (Extended Hours)","",""
"35993699762802","11635.8","-0.31","EURd","SWAP","PROCESSED","2023-08-05 21:17:57","","TSLA","Tesla Inc (Extended Hours)","",""
"35993698713754","11636.11","-0.31","EURd","SWAP","PROCESSED","2023-08-05 21:17:56","","TSLA","Tesla Inc (Extended Hours)","",""
"35993635807165","11636.42","-0.29","EURd","SWAP","PROCESSED","2023-08-05 21:16:56","","BBVA","BBVA","",""
"35993264609187","11636.71","-0.14","EURd","SWAP","PROCESSED","2023-08-05 21:11:02","","AAPL","Apple Inc (Extended Hours)","",""
"35993263560316","11636.85","-0.14","EURd","SWAP","PROCESSED","2023-08-05 21:11:01","","AAPL","Apple Inc (Extended Hours)","",""
"35993263560277","11636.99","-0.14","EURd","SWAP","PROCESSED","2023-08-05 21:11:01","","AAPL","Apple Inc (Extended Hours)","",""
"35993262511292","11637.13","-0.14","EURd","SWAP","PROCESSED","2023-08-05 21:11:00","","AAPL","Apple Inc (Extended Hours)","",""
"35992898659407","11637.27","-0.82","EURd","SWAP","PROCESSED","2023-08-05 21:05:13","","BTC/USD","Bitcoin / USD","",""
"35992897610489","11638.09","-0.82","EURd","SWAP","PROCESSED","2023-08-05 21:05:12","","BTC/USD","Bitcoin / USD","",""
"35992850421767","11638.91","-0.23","EURd","SWAP","PROCESSED","2023-08-05 21:04:27","","SANe","Banco Santander","",""
"35992779121694","11639.14","-0.3","EURd","SWAP","PROCESSED","2023-08-05 21:03:19","","PYPL","PayPal Holdings (Extended Hours)","",""
"35903821081637","11639.44","-0.29","EURd","SWAP","PROCESSED","2023-08-04 21:29:22","","BBVA","BBVA","",""
"35903741390266","11639.73","-0.82","EURd","SWAP","PROCESSED","2023-08-04 21:28:06","","BTC/USD","Bitcoin / USD","",""
"35903740341361","11640.55","-0.82","EURd","SWAP","PROCESSED","2023-08-04 21:28:05","","BTC/USD","Bitcoin / USD","",""
"35903654356638","11641.37","-0.23","EURd","SWAP","PROCESSED","2023-08-04 21:26:43","","SANe","Banco Santander","",""
"35903264292053","11641.6","-0.3","EURd","SWAP","PROCESSED","2023-08-04 21:20:31","","PYPL","PayPal Holdings (Extended Hours)","",""
"35903140559816","11641.9","-0.14","EURd","SWAP","PROCESSED","2023-08-04 21:18:33","","AAPL","Apple Inc (Extended Hours)","",""
"35903140559533","11642.04","-0.14","EURd","SWAP","PROCESSED","2023-08-04 21:18:33","","AAPL","Apple Inc (Extended Hours)","",""
"35903139510929","11642.18","-0.14","EURd","SWAP","PROCESSED","2023-08-04 21:18:32","","AAPL","Apple Inc (Extended Hours)","",""
"35903138461931","11642.32","-0.14","EURd","SWAP","PROCESSED","2023-08-04 21:18:31","","AAPL","Apple Inc (Extended Hours)","",""
"35902314269847","11642.46","-0.31","EURd","SWAP","PROCESSED","2023-08-04 21:05:25","","TSLA","Tesla Inc (Extended Hours)","",""
"35902312171816","11642.77","-0.31","EURd","SWAP","PROCESSED","2023-08-04 21:05:23","","TSLA","Tesla Inc (Extended Hours)","",""
"35885825414515","11643.08","1.16","EURd","TRADE","PROCESSED","2023-08-04 16:43:20","0015421d-0055-311e-0000-4c7500052c78_0015421d-0055-311e-0000-000080e071c9","ETH/USD","Ethereum / USD","",""
"35885818074450","11641.92","-6.12","EURd","TRADE","PROCESSED","2023-08-04 16:43:13","00353194-0055-311e-0000-4c750010f1b2_00353194-0055-311e-0000-00008021411e","MSFT","Microsoft Corp (Extended Hours)","",""
"35885818074449","11648.04","10.97","EURd","TRADE","PROCESSED","2023-08-04 16:43:13","00353194-0055-311e-0000-4c750010f1b1_00353194-0055-311e-0000-00008021439c","MSFT","Microsoft Corp (Extended Hours)","",""
"35885814928714","11637.07","-32.74","EURd","TRADE","PROCESSED","2023-08-04 16:43:10","00396101-0055-311e-0000-4c750010f12b_00396101-0055-311e-0000-000080239565","NVDA","NVIDIA Corp (Extended Hours)","",""
"35885814928713","11669.81","39.81","EURd","TRADE","PROCESSED","2023-08-04 16:43:10","00396101-0055-311e-0000-4c750010f12a_00396101-0055-311e-0000-000080239987","NVDA","NVIDIA Corp (Extended Hours)","",""
"35885792908452","11630","34.8","EURd","TRADE","PROCESSED","2023-08-04 16:42:49","00001344-0055-311e-0000-4c750010ee28_00001344-0055-311e-0000-000080213f48","AMD","Advanced Micro Devices Inc (Extended Hours)","",""
"35854469845701","11595.2","-13.72","EURd","TRADE","PROCESSED","2023-08-04 08:24:57","00513301-0055-311e-0000-4c7500043951_00513301-0055-311e-0000-0000808051c3","TSLA","Tesla Inc (Extended Hours)","",""
"35854469845700","11608.92","8.13","EURd","TRADE","PROCESSED","2023-08-04 08:24:57","00513301-0055-311e-0000-4c7500043950_00513301-0055-311e-0000-000080809f1e","TSLA","Tesla Inc (Extended Hours)","",""
"35854469845699","11600.79","-20.63","EURd","TRADE","PROCESSED","2023-08-04 08:24:57","00513301-0055-311e-0000-4c750004394f_00513301-0055-311e-0000-0000807f365c","TSLA","Tesla Inc (Extended Hours)","",""
"35854469845698","11621.42","47.05","EURd","TRADE","PROCESSED","2023-08-04 08:24:57","00513301-0055-311e-0000-4c750004394e_00513301-0055-311e-0000-00008080b4ef","TSLA","Tesla Inc (Extended Hours)","",""
"35854463554227","11574.37","0.82","EURd","TRADE","PROCESSED","2023-08-04 08:24:51","00018387-0055-311e-0000-4c750004c84b_00018387-0055-311e-0000-000080dc6ce2","Natural Gas","Natural Gas","",""
"35854463554226","11573.55","26.03","EURd","TRADE","PROCESSED","2023-08-04 08:24:51","00018387-0055-311e-0000-4c750004c84a_00018387-0055-311e-0000-000080dc8531","Natural Gas","Natural Gas","",""
"35854457262760","11547.52","55.96","EURd","TRADE","PROCESSED","2023-08-04 08:24:45","0004d68e-0055-311e-0000-4c750000f1aa_0004d68e-0055-311e-0000-000080267072","AMZN","Amazon.com Inc (Extended Hours)","",""
"35854457262759","11491.56","84.38","EURd","TRADE","PROCESSED","2023-08-04 08:24:45","0004d68e-0055-311e-0000-4c750000f1a9_0004d68e-0055-311e-0000-00008026736e","AMZN","Amazon.com Inc (Extended Hours)","",""
"35813440125788","11407.18","-0.36","EURd","SWAP","PROCESSED","2023-08-03 21:32:48","","TSLA","Tesla Inc (Extended Hours)","",""
"35813438027986","11407.54","-0.36","EURd","SWAP","PROCESSED","2023-08-03 21:32:46","","TSLA","Tesla Inc (Extended Hours)","",""
"35813431733784","11407.9","-0.16","EURd","SWAP","PROCESSED","2023-08-03 21:32:40","","TSLA","Tesla Inc (Extended Hours)","",""
"35813424390757","11408.06","-0.16","EURd","SWAP","PROCESSED","2023-08-03 21:32:33","","TSLA","Tesla Inc (Extended Hours)","",""
"35813251375807","11408.22","-0.94","EURd","SWAP","PROCESSED","2023-08-03 21:29:48","","Natural Gas","Natural Gas","",""
"35813246131172","11409.16","-0.94","EURd","SWAP","PROCESSED","2023-08-03 21:29:43","","Natural Gas","Natural Gas","",""
"35813176931080","11410.1","-0.33","EURd","SWAP","PROCESSED","2023-08-03 21:28:37","","NVDA","NVIDIA Corp (Extended Hours)","",""
"35813175882116","11410.43","-0.33","EURd","SWAP","PROCESSED","2023-08-03 21:28:36","","NVDA","NVIDIA Corp (Extended Hours)","",""
"35812181834778","11410.76","-0.16","EURd","SWAP","PROCESSED","2023-08-03 21:12:48","","MSFT","Microsoft Corp (Extended Hours)","",""
"35812180785990","11410.92","-0.24","EURd","SWAP","PROCESSED","2023-08-03 21:12:47","","MSFT","Microsoft Corp (Extended Hours)","",""
"35811628177238","11411.16","-0.26","EURd","SWAP","PROCESSED","2023-08-03 21:04:00","","AMZN","Amazon.com Inc (Extended Hours)","",""
"35811628177074","11411.42","-0.26","EURd","SWAP","PROCESSED","2023-08-03 21:04:00","","AMZN","Amazon.com Inc (Extended Hours)","",""
"35722771856722","11411.68","-0.35","EURd","SWAP","PROCESSED","2023-08-02 21:31:40","","TSLA","Tesla Inc (Extended Hours)","",""
"35722762415765","11412.03","-0.16","EURd","SWAP","PROCESSED","2023-08-02 21:31:31","","TSLA","Tesla Inc (Extended Hours)","",""
"35722754024075","11412.19","-0.16","EURd","SWAP","PROCESSED","2023-08-02 21:31:23","","TSLA","Tesla Inc (Extended Hours)","",""
"35722569470755","11412.35","-0.32","EURd","SWAP","PROCESSED","2023-08-02 21:28:27","","NVDA","NVIDIA Corp (Extended Hours)","",""
"35722437350413","11412.67","-1","EURd","SWAP","PROCESSED","2023-08-02 21:26:21","","Natural Gas","Natural Gas","",""
"35722005338542","11413.67","-0.25","EURd","SWAP","PROCESSED","2023-08-02 21:19:29","","AMZN","Amazon.com Inc (Extended Hours)","",""
"35720962010201","11413.92","-0.24","EURd","SWAP","PROCESSED","2023-08-02 21:02:54","","MSFT","Microsoft Corp (Extended Hours)","",""
"35653238679618","11414.16","2.54","EURd","TRADE","PROCESSED","2023-08-02 03:06:28","0015421d-0055-311e-0000-4c73000176ff_0015421d-0055-311e-0000-000080e0607f","ETH/USD","Ethereum / USD","",""
"35653238679617","11411.62","2.72","EURd","TRADE","PROCESSED","2023-08-02 03:06:28","0015421d-0055-311e-0000-4c73000176fe_0015421d-0055-311e-0000-000080e06382","ETH/USD","Ethereum / USD","",""
"35653238679616","11408.9","-2.53","EURd","TRADE","PROCESSED","2023-08-02 03:06:28","0015421d-0055-311e-0000-4c73000176fd_0015421d-0055-311e-0000-000080e037a0","ETH/USD","Ethereum / USD","",""
"35653223999535","11411.43","9.58","EURd","TRADE","PROCESSED","2023-08-02 03:06:14","000940dd-0055-311e-0000-4c730001e67b_000940dd-0055-311e-0000-0000819f4811","BTC/USD","Bitcoin / USD","",""
"35653223999534","11401.85","7.61","EURd","TRADE","PROCESSED","2023-08-02 03:06:14","000940dd-0055-311e-0000-4c730001e67a_000940dd-0055-311e-0000-0000819ecb2f","BTC/USD","Bitcoin / USD","",""
"35632198992120","11394.24","-0.35","EURd","SWAP","PROCESSED","2023-08-01 21:32:03","","TSLA","Tesla Inc (Extended Hours)","",""
"35632187469625","11394.59","-0.16","EURd","SWAP","PROCESSED","2023-08-01 21:31:52","","TSLA","Tesla Inc (Extended Hours)","",""
"35632178029209","11394.75","-0.16","EURd","SWAP","PROCESSED","2023-08-01 21:31:43","","TSLA","Tesla Inc (Extended Hours)","",""
"35631888627481","11394.91","-1","EURd","SWAP","PROCESSED","2023-08-01 21:27:07","","Natural Gas","Natural Gas","",""
"35631802644259","11395.91","-0.33","EURd","SWAP","PROCESSED","2023-08-01 21:25:45","","NVDA","NVIDIA Corp (Extended Hours)","",""
"35631137842694","11396.24","-0.24","EURd","SWAP","PROCESSED","2023-08-01 21:15:11","","MSFT","Microsoft Corp (Extended Hours)","",""
"35630886187312","11396.48","-0.32","EURd","SWAP","PROCESSED","2023-08-01 21:11:11","","ETH/USD","Ethereum / USD","",""
"35630885138439","11396.8","-0.11","EURd","SWAP","PROCESSED","2023-08-01 21:11:10","","ETH/USD","Ethereum / USD","",""
"35630881991790","11396.91","-0.21","EURd","SWAP","PROCESSED","2023-08-01 21:11:07","","ETH/USD","Ethereum / USD","",""
"35630652348214","11397.12","-0.34","EURd","SWAP","PROCESSED","2023-08-01 21:07:28","","BTC/USD","Bitcoin / USD","",""
"35630645005339","11397.46","-0.34","EURd","SWAP","PROCESSED","2023-08-01 21:07:21","","BTC/USD","Bitcoin / USD","",""
"35630510786705","11397.8","-0.25","EURd","SWAP","PROCESSED","2023-08-01 21:05:13","","AMZN","Amazon.com Inc (Extended Hours)","",""
"35628161979377","11398.05","0.18","EURd","TRADE","PROCESSED","2023-08-01 20:27:53","00001344-0055-311e-0000-4c720016f383_00001344-0055-311e-0000-0000802137ae","AMD","Advanced Micro Devices Inc (Extended Hours)","",""
"35628007838420","11397.87","15.39","EURd","TRADE","PROCESSED","2023-08-01 20:25:26","00001344-0055-311e-0000-4c720016efd7_00001344-0055-311e-0000-0000802137a2","AMD","Advanced Micro Devices Inc (Extended Hours)","",""
"35627525492403","11382.48","77.59","EURd","TRADE","PROCESSED","2023-08-01 20:17:46","00001344-0055-311e-0000-4c720016e350_00001344-0055-311e-0000-000080213160","AMD","Advanced Micro Devices Inc (Extended Hours)","",""
"35627461529103","11304.89","-18.63","EURd","TRADE","PROCESSED","2023-08-01 20:16:45","00001344-0055-311e-0000-4c720016e0af_00001344-0055-311e-0000-0000801e505e","AMD","Advanced Micro Devices Inc (Extended Hours)","",""
"35627461529102","11323.52","-16.55","EURd","TRADE","PROCESSED","2023-08-01 20:16:45","00001344-0055-311e-0000-4c720016e0ae_00001344-0055-311e-0000-0000801e4da9","AMD","Advanced Micro Devices Inc (Extended Hours)","",""
"35627461529101","11340.07","-2.55","EURd","TRADE","PROCESSED","2023-08-01 20:16:45","00001344-0055-311e-0000-4c720016e0ad_00001344-0055-311e-0000-0000801e5394","AMD","Advanced Micro Devices Inc (Extended Hours)","",""
"35627461529099","11342.62","31.87","EURd","TRADE","PROCESSED","2023-08-01 20:16:45","00001344-0055-311e-0000-4c720016e0ac_00001344-0055-311e-0000-000080211ecd","AMD","Advanced Micro Devices Inc (Extended Hours)","",""
"35627461529098","11310.75","35.24","EURd","TRADE","PROCESSED","2023-08-01 20:16:45","00001344-0055-311e-0000-4c720016e0ab_00001344-0055-311e-0000-000080211ec8","AMD","Advanced Micro Devices Inc (Extended Hours)","",""
"35627461529096","11275.51","35.7","EURd","TRADE","PROCESSED","2023-08-01 20:16:45","00001344-0055-311e-0000-4c720016e0aa_00001344-0055-311e-0000-000080211ec5","AMD","Advanced Micro Devices Inc (Extended Hours)","",""
"35627461529095","11239.81","-21.49","EURd","TRADE","PROCESSED","2023-08-01 20:16:45","00001344-0055-311e-0000-4c720016e0a9_00001344-0055-311e-0000-0000801e4ce0","AMD","Advanced Micro Devices Inc (Extended Hours)","",""
"35627403857156","11261.3","8.2","EURd","TRADE","PROCESSED","2023-08-01 20:15:50","00001344-0055-311e-0000-4c720016ddec_00001344-0055-311e-0000-00008021251b","AMD","Advanced Micro Devices Inc (Extended Hours)","",""
"35627403857155","11253.1","4.19","EURd","TRADE","PROCESSED","2023-08-01 20:15:50","00001344-0055-311e-0000-4c720016ddeb_00001344-0055-311e-0000-000080212524","AMD","Advanced Micro Devices Inc (Extended Hours)","",""
"35161213271533","11248.91","30.56","EURd","TRADE","PROCESSED","2023-07-27 16:45:56","00001344-0055-311e-0000-4c6d001a0c9c_00001344-0055-311e-0000-000080212789","AMD","Advanced Micro Devices Inc (Extended Hours)","",""
"34861170589508","11218.35","-13.98","EURd","TRADE","PROCESSED","2023-07-24 09:16:53","000144cd-0055-311e-0000-4c6a0005f51c_000144cd-0055-311e-0000-0000804802e8","TSM","Taiwan Semiconductor Manufacturing Co Ltd - ADR (Extended Hours)","",""
"34515317705951","11232.33","-0.95","EURd","TRADE","PROCESSED","2023-07-20 13:39:42","00396101-0055-311e-0000-4c660004f50b_00396101-0055-311e-0000-000080236bda","NVDA","NVIDIA Corp (Extended Hours)","",""
"34515317705950","11233.28","-11.09","EURd","TRADE","PROCESSED","2023-07-20 13:39:42","00396101-0055-311e-0000-4c660004f50a_00396101-0055-311e-0000-000080236bd1","NVDA","NVIDIA Corp (Extended Hours)","",""
"34515317705949","11244.37","-12.75","EURd","TRADE","PROCESSED","2023-07-20 13:39:42","00396101-0055-311e-0000-4c660004f509_00396101-0055-311e-0000-000080236b47","NVDA","NVIDIA Corp (Extended Hours)","",""
"34442144931452","11257.12","3.04","EURd","TRADE","PROCESSED","2023-07-19 18:16:39","00001344-0055-311e-0000-4c650024c160_00001344-0055-311e-0000-000080212645","AMD","Advanced Micro Devices Inc (Extended Hours)","",""
"34442141785716","11254.08","2.68","EURd","TRADE","PROCESSED","2023-07-19 18:16:36","00001344-0055-311e-0000-4c650024c0c2_00001344-0055-311e-0000-000080212647","AMD","Advanced Micro Devices Inc (Extended Hours)","",""
"34431261758398","11251.4","3.44","EURd","TRADE","PROCESSED","2023-07-19 15:23:40","00001344-0055-311e-0000-4c650014228a_00001344-0055-311e-0000-000080212431","AMD","Advanced Micro Devices Inc (Extended Hours)","",""
"34431255466894","11247.96","4.82","EURd","TRADE","PROCESSED","2023-07-19 15:23:34","00001344-0055-311e-0000-4c6500141f76_00001344-0055-311e-0000-0000802125e8","AMD","Advanced Micro Devices Inc (Extended Hours)","",""
"34431241835305","11243.14","11.12","EURd","TRADE","PROCESSED","2023-07-19 15:23:21","00396101-0055-311e-0000-4c65001416c8_00396101-0055-311e-0000-000080236a80","NVDA","NVIDIA Corp (Extended Hours)","",""
"34429451919052","11232.02","5.98","EURd","TRADE","PROCESSED","2023-07-19 14:54:54","00396101-0055-311e-0000-4c650010ea8c_00396101-0055-311e-0000-000080236996","NVDA","NVIDIA Corp (Extended Hours)","",""
"34429451919050","11226.04","3.68","EURd","TRADE","PROCESSED","2023-07-19 14:54:54","00396101-0055-311e-0000-4c650010ea8b_00396101-0055-311e-0000-00008023698f","NVDA","NVIDIA Corp (Extended Hours)","",""
"34428718957171","11222.36","3.83","EURd","TRADE","PROCESSED","2023-07-19 14:43:15","00353194-0055-311e-0000-4c65000f8aeb_00353194-0055-311e-0000-0000802128c5","MSFT","Microsoft Corp (Extended Hours)","",""
"34424998609136","11218.53","13.55","EURd","TRADE","PROCESSED","2023-07-19 13:44:07","000144cd-0055-311e-0000-4c65000b6770_000144cd-0055-311e-0000-0000804802b9","TSM","Taiwan Semiconductor Manufacturing Co Ltd - ADR (Extended Hours)","",""
"34424983928957","11204.98","2.65","EURd","TRADE","PROCESSED","2023-07-19 13:43:53","0015421d-0055-311e-0000-4c650009e985_0015421d-0055-311e-0000-000080df81ba","ETH/USD","Ethereum / USD","",""
"34424981831790","11202.33","4.03","EURd","TRADE","PROCESSED","2023-07-19 13:43:51","000940dd-0055-311e-0000-4c65000fc321_000940dd-0055-311e-0000-0000819d7320","BTC/USD","Bitcoin / USD","",""
"34424978686034","11198.3","9.98","EURd","TRADE","PROCESSED","2023-07-19 13:43:48","0004d68e-0055-311e-0000-4c650005e09a_0004d68e-0055-311e-0000-000080264cb2","AMZN","Amazon.com Inc (Extended Hours)","",""
"34422442192910","11188.32","-11.98","EURd","TRADE","PROCESSED","2023-07-19 13:03:29","00081081-0055-311e-0000-4c650001c229_00081081-0055-311e-0000-000080211262","BABA","Alibaba Group Holding Limited (Extended Hours)","",""
"34422442192909","11200.3","27.81","EURd","TRADE","PROCESSED","2023-07-19 13:03:29","00081081-0055-311e-0000-4c650001c228_00081081-0055-311e-0000-0000802113cb","BABA","Alibaba Group Holding Limited (Extended Hours)","",""
"34422442192908","11172.49","22.91","EURd","TRADE","PROCESSED","2023-07-19 13:03:29","00081081-0055-311e-0000-4c650001c227_00081081-0055-311e-0000-0000802113c9","BABA","Alibaba Group Holding Limited (Extended Hours)","",""
"34357450400269","11149.58","10.42","EURd","TRADE","PROCESSED","2023-07-18 19:50:28","004433cd-0055-311e-0000-4c6400291ca8_004433cd-0055-311e-0000-0000802001ac","QCOM","QUALCOMM Inc (Extended Hours)","",""
"34347699685492","11139.16","7.22","EURd","TRADE","PROCESSED","2023-07-18 17:15:29","00018387-0055-311e-0000-4c64001d7ab0_00018387-0055-311e-0000-000080db17dc","Natural Gas","Natural Gas","",""
"34347699685490","11131.94","33.87","EURd","TRADE","PROCESSED","2023-07-18 17:15:29","00018387-0055-311e-0000-4c64001d7aaf_00018387-0055-311e-0000-000080db175d","Natural Gas","Natural Gas","",""
"34347699685487","11098.07","6.42","EURd","TRADE","PROCESSED","2023-07-18 17:15:29","00018387-0055-311e-0000-4c64001d7aae_00018387-0055-311e-0000-000080db2a42","Natural Gas","Natural Gas","",""
"34347699685484","11091.65","10.16","EURd","TRADE","PROCESSED","2023-07-18 17:15:29","00018387-0055-311e-0000-4c64001d7aad_00018387-0055-311e-0000-000080db469f","Natural Gas","Natural Gas","",""
"34347699685482","11081.49","-4.9","EURd","TRADE","PROCESSED","2023-07-18 17:15:29","00018387-0055-311e-0000-4c64001d7aac_00018387-0055-311e-0000-000080dafeba","Natural Gas","Natural Gas","",""
"34347699685480","11086.39","28.08","EURd","TRADE","PROCESSED","2023-07-18 17:15:29","00018387-0055-311e-0000-4c64001d7aab_00018387-0055-311e-0000-000080db11a0","Natural Gas","Natural Gas","",""
"34275724378969","11058.31","1.96","EURd","TRADE","PROCESSED","2023-07-17 22:11:28","0024e503-0055-311e-0000-4c6300274212_0024e503-0055-311e-0000-000080200aa1","INTC","Intel Corp (Extended Hours)","",""
"34275724378968","11056.35","0.31","EURd","TRADE","PROCESSED","2023-07-17 22:11:28","0024e503-0055-311e-0000-4c6300274211_0024e503-0055-311e-0000-000080200a3e","INTC","Intel Corp (Extended Hours)","",""
"34275717038920","11056.04","20.02","EURd","TRADE","PROCESSED","2023-07-17 22:11:21","00001344-0055-311e-0000-4c6300274201_00001344-0055-311e-0000-0000802120d5","AMD","Advanced Micro Devices Inc (Extended Hours)","",""
"34271897085152","11036.02","0","EURd","SWAP","PROCESSED","2023-07-17 21:10:38","","Natural Gas","Natural Gas","",""
"34271889742592","11036.02","0","EURd","SWAP","PROCESSED","2023-07-17 21:10:31","","Natural Gas","Natural Gas","",""
"34271886595714","11036.02","0","EURd","SWAP","PROCESSED","2023-07-17 21:10:28","","Natural Gas","Natural Gas","",""
"34271886595527","11036.02","0.04","EURd","SWAP","PROCESSED","2023-07-17 21:10:28","","Natural Gas","Natural Gas","",""
"34271885546623","11035.98","0.04","EURd","SWAP","PROCESSED","2023-07-17 21:10:27","","Natural Gas","Natural Gas","",""
"34271880301809","11035.94","0.04","EURd","SWAP","PROCESSED","2023-07-17 21:10:22","","Natural Gas","Natural Gas","",""
"34245349235350","11035.9","0.89","EURd","TRADE","PROCESSED","2023-07-17 14:08:40","0041940c-0055-311e-0000-4c63000b5d94_0041940c-0055-311e-0000-000080200c69","PYPL","PayPal Holdings (Extended Hours)","",""
"34182993567019","11035.01","0.01","EURd","SWAP","PROCESSED","2023-07-16 21:37:33","","Natural Gas","Natural Gas","",""
"34182986225476","11035","0.01","EURd","SWAP","PROCESSED","2023-07-16 21:37:26","","Natural Gas","Natural Gas","",""
"34182985176782","11034.99","0.06","EURd","SWAP","PROCESSED","2023-07-16 21:37:25","","Natural Gas","Natural Gas","",""
"34182984127819","11034.93","0.06","EURd","SWAP","PROCESSED","2023-07-16 21:37:24","","Natural Gas","Natural Gas","",""
"34182975737125","11034.87","0.06","EURd","SWAP","PROCESSED","2023-07-16 21:37:16","","Natural Gas","Natural Gas","",""
"34091960391712","11034.81","0.01","EURd","SWAP","PROCESSED","2023-07-15 21:30:37","","Natural Gas","Natural Gas","",""
"34091955147224","11034.8","0.01","EURd","SWAP","PROCESSED","2023-07-15 21:30:32","","Natural Gas","Natural Gas","",""
"34091954098531","11034.79","0.06","EURd","SWAP","PROCESSED","2023-07-15 21:30:31","","Natural Gas","Natural Gas","",""
"34091953049567","11034.73","0.06","EURd","SWAP","PROCESSED","2023-07-15 21:30:30","","Natural Gas","Natural Gas","",""
"34091944658868","11034.67","0.06","EURd","SWAP","PROCESSED","2023-07-15 21:30:22","","Natural Gas","Natural Gas","",""
"34001398033814","11034.61","0.01","EURd","SWAP","PROCESSED","2023-07-14 21:31:10","","Natural Gas","Natural Gas","",""
"34001390692266","11034.6","0.01","EURd","SWAP","PROCESSED","2023-07-14 21:31:03","","Natural Gas","Natural Gas","",""
"34001389643566","11034.59","0.06","EURd","SWAP","PROCESSED","2023-07-14 21:31:02","","Natural Gas","Natural Gas","",""
"34001387546031","11034.53","0.06","EURd","SWAP","PROCESSED","2023-07-14 21:31:00","","Natural Gas","Natural Gas","",""
"34001380203972","11034.47","0.06","EURd","SWAP","PROCESSED","2023-07-14 21:30:53","","Natural Gas","Natural Gas","",""
"33983647742015","11034.41","5.69","EURd","TRADE","PROCESSED","2023-07-14 16:49:02","00001344-0055-311e-0000-4c60001e8850_00001344-0055-311e-0000-000080211320","AMD","Advanced Micro Devices Inc (Extended Hours)","",""
"33983646693400","11028.72","2.49","EURd","TRADE","PROCESSED","2023-07-14 16:49:01","00001344-0055-311e-0000-4c60001e87bc_00001344-0055-311e-0000-0000802103de","AMD","Advanced Micro Devices Inc (Extended Hours)","",""
"33973929538685","11026.23","1.32","EURd","TRADE","PROCESSED","2023-07-14 14:14:34","00000182-0055-311e-0000-4c6000108cf4_00000182-0055-311e-0000-0000804a2508","META","Meta Platforms Inc (Extended Hours)","",""
"33973926392841","11024.91","6.7","EURd","TRADE","PROCESSED","2023-07-14 14:14:31","0004d68e-0055-311e-0000-4c60000c61f6_0004d68e-0055-311e-0000-00008026417f","AMZN","Amazon.com Inc (Extended Hours)","",""
"33973922198399","11018.21","7.88","EURd","TRADE","PROCESSED","2023-07-14 14:14:27","000144cd-0055-311e-0000-4c60001050fe_000144cd-0055-311e-0000-000080480271","TSM","Taiwan Semiconductor Manufacturing Co Ltd - ADR (Extended Hours)","",""
"33973922198398","11010.33","5.61","EURd","TRADE","PROCESSED","2023-07-14 14:14:27","000144cd-0055-311e-0000-4c60001050fd_000144cd-0055-311e-0000-00008048027a","TSM","Taiwan Semiconductor Manufacturing Co Ltd - ADR (Extended Hours)","",""
"33959465473826","11004.72","0.27","EURd","TRADE","PROCESSED","2023-07-14 10:24:40","00016258-0055-311e-0000-4c6000070f5b_00016258-0055-311e-0000-0000804c1fe9","VIX","Volatility Index","",""
"33918968420129","11004.45","4.19","EURd","TRADE","PROCESSED","2023-07-13 23:40:59","00001344-0055-311e-0000-4c5f0026e996_00001344-0055-311e-0000-000080211115","AMD","Advanced Micro Devices Inc (Extended Hours)","",""
"33916181301441","11000.26","11.76","EURd","TRADE","PROCESSED","2023-07-13 22:56:41","00001344-0055-311e-0000-4c5f0026d629_00001344-0055-311e-0000-000080211da1","AMD","Advanced Micro Devices Inc (Extended Hours)","",""
"33916180252864","10988.5","12.29","EURd","TRADE","PROCESSED","2023-07-13 22:56:40","00001344-0055-311e-0000-4c5f0026d61c_00001344-0055-311e-0000-000080211bc4","AMD","Advanced Micro Devices Inc (Extended Hours)","",""
"33910624906464","10976.21","-1.37","EURd","SWAP","PROCESSED","2023-07-13 21:28:22","","VIX","Volatility Index","",""
"33910463423820","10977.58","0.07","EURd","SWAP","PROCESSED","2023-07-13 21:25:48","","Natural Gas","Natural Gas","",""
"33910462375010","10977.51","0.37","EURd","SWAP","PROCESSED","2023-07-13 21:25:47","","Natural Gas","Natural Gas","",""
"33910458179715","10977.14","0.37","EURd","SWAP","PROCESSED","2023-07-13 21:25:42","","Natural Gas","Natural Gas","",""
"33910445593934","10976.77","0.37","EURd","SWAP","PROCESSED","2023-07-13 21:25:31","","Natural Gas","Natural Gas","",""
"33899314959708","10976.4","16.05","EURd","TRADE","PROCESSED","2023-07-13 18:28:36","00001344-0055-311e-0000-4c5f001fae76_00001344-0055-311e-0000-00008021043a","AMD","Advanced Micro Devices Inc (Extended Hours)","",""
"33899310765326","10960.35","15.69","EURd","TRADE","PROCESSED","2023-07-13 18:28:32","00001344-0055-311e-0000-4c5f001fad65_00001344-0055-311e-0000-0000802104b7","AMD","Advanced Micro Devices Inc (Extended Hours)","",""
"33898570478955","10944.66","0.51","EURd","TRADE","PROCESSED","2023-07-13 18:16:46","000940dd-0055-311e-0000-4c5f00192442_000940dd-0055-311e-0000-0000819cd159","BTC/USD","Bitcoin / USD","",""
"33896135681054","10944.15","0.23","EURd","TRADE","PROCESSED","2023-07-13 17:38:04","00000182-0055-311e-0000-4c5f0017ea96_00000182-0055-311e-0000-0000804a21a7","META","Meta Platforms Inc (Extended Hours)","",""
"33896132535291","10943.92","0.91","EURd","TRADE","PROCESSED","2023-07-13 17:38:01","00513301-0055-311e-0000-4c5f0017ea07_00513301-0055-311e-0000-0000807eabd2","TSLA","Tesla Inc (Extended Hours)","",""
"33896132535289","10943.01","5.73","EURd","TRADE","PROCESSED","2023-07-13 17:38:01","00513301-0055-311e-0000-4c5f0017ea06_00513301-0055-311e-0000-0000807eb3ad","TSLA","Tesla Inc (Extended Hours)","",""
"33888775727704","10937.28","20.91","EURd","TRADE","PROCESSED","2023-07-13 15:41:05","0015421d-0055-311e-0000-4c5f000843ea_0015421d-0055-311e-0000-000080df478f","ETH/USD","Ethereum / USD","",""
"33888775727703","10916.37","21.99","EURd","TRADE","PROCESSED","2023-07-13 15:41:05","0015421d-0055-311e-0000-4c5f000843e9_0015421d-0055-311e-0000-000080df468e","ETH/USD","Ethereum / USD","",""
"33815867184151","10894.38","4.85","EURd","TRADE","PROCESSED","2023-07-12 20:22:14","0024e503-0055-311e-0000-4c5e002c15ae_0024e503-0055-311e-0000-000080200187","INTC","Intel Corp (Extended Hours)","",""
"33815867184150","10889.53","11.32","EURd","TRADE","PROCESSED","2023-07-12 20:22:14","0024e503-0055-311e-0000-4c5e002c15ad_0024e503-0055-311e-0000-000080200189","INTC","Intel Corp (Extended Hours)","",""
"33815867184149","10878.21","-28.02","EURd","TRADE","PROCESSED","2023-07-12 20:22:14","0024e503-0055-311e-0000-4c5e002c15ac_0024e503-0055-311e-0000-000080200125","INTC","Intel Corp (Extended Hours)","",""
"33815867184148","10906.23","8.89","EURd","TRADE","PROCESSED","2023-07-12 20:22:14","0024e503-0055-311e-0000-4c5e002c15ab_0024e503-0055-311e-0000-00008020069e","INTC","Intel Corp (Extended Hours)","",""
"33815867184147","10897.34","3.77","EURd","TRADE","PROCESSED","2023-07-12 20:22:14","0024e503-0055-311e-0000-4c5e002c15aa_0024e503-0055-311e-0000-000080200167","INTC","Intel Corp (Extended Hours)","",""
"33815867184146","10893.57","19.58","EURd","TRADE","PROCESSED","2023-07-12 20:22:14","0024e503-0055-311e-0000-4c5e002c15a9_0024e503-0055-311e-0000-0000802001cf","INTC","Intel Corp (Extended Hours)","",""
"32954431601191","10873.99","88.63","EURd","TRADE","PROCESSED","2023-07-03 08:10:05","00513301-0055-311e-0000-4c550007be26_00513301-0055-311e-0000-0000807d75f6","TSLA","Tesla Inc (Extended Hours)","",""
"32954431601185","10785.36","29.27","EURd","TRADE","PROCESSED","2023-07-03 08:10:05","00513301-0055-311e-0000-4c550007be25_00513301-0055-311e-0000-0000807d9598","TSLA","Tesla Inc (Extended Hours)","",""
"32082649702101","10756.09","10.06","EURd","TRADE","PROCESSED","2023-06-23 17:13:29","0015421d-0055-311e-0000-4c4b000c98bb_0015421d-0055-311e-0000-000080dd3fbf","ETH/USD","Ethereum / USD","",""
"31995054807566","10746.03","0.58","EURd","TRADE","PROCESSED","2023-06-22 18:01:12","0015421d-0055-311e-0000-4c4a000c9b3e_0015421d-0055-311e-0000-000080dd472a","ETH/USD","Ethereum / USD","",""
"31958503548923","10745.45","-11.51","EURd","TRADE","PROCESSED","2023-06-22 08:20:14","00353194-0055-311e-0000-4c4a00001d00_00353194-0055-311e-0000-00008021026e","MSFT","Microsoft Corp (Extended Hours)","",""
"31958503548922","10756.96","-1.39","EURd","TRADE","PROCESSED","2023-06-22 08:20:14","00353194-0055-311e-0000-4c4a00001cff_00353194-0055-311e-0000-00008021032d","MSFT","Microsoft Corp (Extended Hours)","",""
"31896600863962","10758.35","3.89","EURd","TRADE","PROCESSED","2023-06-21 15:56:19","0015421d-0055-311e-0000-4c4900091649_0015421d-0055-311e-0000-000080dd36f3","ETH/USD","Ethereum / USD","",""
"31895595274128","10754.46","11.75","EURd","TRADE","PROCESSED","2023-06-21 15:40:20","000940dd-0055-311e-0000-4c490014ef01_000940dd-0055-311e-0000-00008199960e","BTC/USD","Bitcoin / USD","",""
"31892079400559","10742.71","9.04","EURd","TRADE","PROCESSED","2023-06-21 14:44:27","0015421d-0055-311e-0000-4c490008215d_0015421d-0055-311e-0000-000080dd35ad","ETH/USD","Ethereum / USD","",""
"31892079400558","10733.67","25.17","EURd","TRADE","PROCESSED","2023-06-21 14:44:27","0015421d-0055-311e-0000-4c490008215c_0015421d-0055-311e-0000-000080db2e03","ETH/USD","Ethereum / USD","",""
"31892079400557","10708.5","15.16","EURd","TRADE","PROCESSED","2023-06-21 14:44:27","0015421d-0055-311e-0000-4c490008215b_0015421d-0055-311e-0000-000080db1ef8","ETH/USD","Ethereum / USD","",""
"31892079400556","10693.34","-0.31","EURd","TRADE","PROCESSED","2023-06-21 14:44:27","0015421d-0055-311e-0000-4c490008215a_0015421d-0055-311e-0000-000080da1656","ETH/USD","Ethereum / USD","",""
"31892079400553","10693.65","16.09","EURd","TRADE","PROCESSED","2023-06-21 14:44:27","0015421d-0055-311e-0000-4c4900082159_0015421d-0055-311e-0000-000080db2d6d","ETH/USD","Ethereum / USD","",""
"31892079400551","10677.56","16.1","EURd","TRADE","PROCESSED","2023-06-21 14:44:27","0015421d-0055-311e-0000-4c4900082158_0015421d-0055-311e-0000-000080db2d67","ETH/USD","Ethereum / USD","",""
"31892079400549","10661.46","15.95","EURd","TRADE","PROCESSED","2023-06-21 14:44:27","0015421d-0055-311e-0000-4c4900082157_0015421d-0055-311e-0000-000080db2d61","ETH/USD","Ethereum / USD","",""
"31892079400548","10645.51","38.74","EURd","TRADE","PROCESSED","2023-06-21 14:44:27","0015421d-0055-311e-0000-4c4900082156_0015421d-0055-311e-0000-000080db2d5a","ETH/USD","Ethereum / USD","",""
"31892079400545","10606.77","-2.19","EURd","TRADE","PROCESSED","2023-06-21 14:44:27","0015421d-0055-311e-0000-4c4900082155_0015421d-0055-311e-0000-000080da0efb","ETH/USD","Ethereum / USD","",""
"31892079400543","10608.96","-2.19","EURd","TRADE","PROCESSED","2023-06-21 14:44:27","0015421d-0055-311e-0000-4c4900082154_0015421d-0055-311e-0000-000080da0efe","ETH/USD","Ethereum / USD","",""
"31892079400537","10611.15","-17.07","EURd","TRADE","PROCESSED","2023-06-21 14:44:27","0015421d-0055-311e-0000-4c4900082153_0015421d-0055-311e-0000-000080da0c24","ETH/USD","Ethereum / USD","",""
"31892079400534","10628.22","2.27","EURd","TRADE","PROCESSED","2023-06-21 14:44:27","0015421d-0055-311e-0000-4c4900082152_0015421d-0055-311e-0000-000080dd3378","ETH/USD","Ethereum / USD","",""
"31892079400531","10625.95","-2.69","EURd","TRADE","PROCESSED","2023-06-21 14:44:27","0015421d-0055-311e-0000-4c4900082151_0015421d-0055-311e-0000-000080da0cb4","ETH/USD","Ethereum / USD","",""
"31889141293141","10628.64","10.34","EURd","TRADE","PROCESSED","2023-06-21 13:57:45","00081081-0055-311e-0000-4c4900069d81_00081081-0055-311e-0000-000080210106","BABA","Alibaba Group Holding Limited (Extended Hours)","",""
"31884359786690","10618.3","2.55","EURd","TRADE","PROCESSED","2023-06-21 12:41:45","000940dd-0055-311e-0000-4c49000cb7fb_000940dd-0055-311e-0000-000081998160","BTC/USD","Bitcoin / USD","",""
"31815160062977","10615.75","11.75","EURd","TRADE","PROCESSED","2023-06-20 18:21:51","000940dd-0055-311e-0000-4c480016ad48_000940dd-0055-311e-0000-000081955097","BTC/USD","Bitcoin / USD","",""
"31815159014363","10604","37.77","EURd","TRADE","PROCESSED","2023-06-20 18:21:50","000940dd-0055-311e-0000-4c480016ad42_000940dd-0055-311e-0000-00008193f5e8","BTC/USD","Bitcoin / USD","",""
"31815159014359","10566.23","13.8","EURd","TRADE","PROCESSED","2023-06-20 18:21:50","000940dd-0055-311e-0000-4c480016ad41_000940dd-0055-311e-0000-00008193a9f8","BTC/USD","Bitcoin / USD","",""
"31815159014356","10552.43","3.19","EURd","TRADE","PROCESSED","2023-06-20 18:21:50","000940dd-0055-311e-0000-4c480016ad40_000940dd-0055-311e-0000-00008193a4ca","BTC/USD","Bitcoin / USD","",""
"31275313285378","10549.24","6.33","EURd","TRADE","PROCESSED","2023-06-14 19:21:13","0024e503-0055-311e-0000-4c4200344115_0024e503-0055-311e-0000-0000801d61b1","INTC","Intel Corp (Extended Hours)","",""
"31246859125621","10542.91","0.33","EURd","TRADE","PROCESSED","2023-06-14 11:48:57","00513301-0055-311e-0000-4c4200080453_00513301-0055-311e-0000-0000807aec6f","TSLA","Tesla Inc (Extended Hours)","",""
"31240236328490","10542.58","8.66","EURd","TRADE","PROCESSED","2023-06-14 10:03:41","00001344-0055-311e-0000-4c420000b79a_00001344-0055-311e-0000-0000801e4e67","AMD","Advanced Micro Devices Inc (Extended Hours)","",""
"31240234231331","10533.92","7.81","EURd","TRADE","PROCESSED","2023-06-14 10:03:39","00001344-0055-311e-0000-4c420000b790_00001344-0055-311e-0000-0000801e4e64","AMD","Advanced Micro Devices Inc (Extended Hours)","",""
"31181898806796","10526.11","3.12","EURd","TRADE","PROCESSED","2023-06-13 18:36:26","00001344-0055-311e-0000-4c41002b0f0d_00001344-0055-311e-0000-0000801e4e5a","AMD","Advanced Micro Devices Inc (Extended Hours)","",""
"31181885175243","10522.99","5.01","EURd","TRADE","PROCESSED","2023-06-13 18:36:13","00001344-0055-311e-0000-4c41002b0957_00001344-0055-311e-0000-0000801e4e57","AMD","Advanced Micro Devices Inc (Extended Hours)","",""
"31181671264824","10517.98","6.45","EURd","TRADE","PROCESSED","2023-06-13 18:32:49","00001344-0055-311e-0000-4c41002aa22e_00001344-0055-311e-0000-0000801e4e43","AMD","Advanced Micro Devices Inc (Extended Hours)","",""
"31181551726294","10511.53","-14.56","EURd","TRADE","PROCESSED","2023-06-13 18:30:55","00001344-0055-311e-0000-4c41002a60be_00001344-0055-311e-0000-0000801e4e4a","AMD","Advanced Micro Devices Inc (Extended Hours)","",""
"31181480422678","10526.09","-21.56","EURd","TRADE","PROCESSED","2023-06-13 18:29:47","0041940c-0055-311e-0000-4c41002a2e94_0041940c-0055-311e-0000-0000801d6aa5","PYPL","PayPal Holdings (Extended Hours)","",""
"31177706598403","10547.65","1.57","EURd","TRADE","PROCESSED","2023-06-13 17:29:48","00018509-0055-311e-0000-4c4100229105_00018509-0055-311e-0000-0000811c97e9","Oil - Crude","Crude Oil","",""
"31168589230327","10546.08","2.28","EURd","TRADE","PROCESSED","2023-06-13 15:04:53","00513301-0055-311e-0000-4c4100111313_00513301-0055-311e-0000-0000807ac566","TSLA","Tesla Inc (Extended Hours)","",""
"31165559891698","10543.8","10.39","EURd","TRADE","PROCESSED","2023-06-13 14:16:44","00018509-0055-311e-0000-4c410013aacc_00018509-0055-311e-0000-0000811c7988","Oil - Crude","Crude Oil","",""
"31164902427532","10533.41","0.61","EURd","TRADE","PROCESSED","2023-06-13 14:06:17","00513301-0055-311e-0000-4c41000e3d21_00513301-0055-311e-0000-0000807ac0ce","TSLA","Tesla Inc (Extended Hours)","",""
"31164902427528","10532.8","0.09","EURd","TRADE","PROCESSED","2023-06-13 14:06:17","00513301-0055-311e-0000-4c41000e3d20_00513301-0055-311e-0000-0000807ac0b1","TSLA","Tesla Inc (Extended Hours)","",""
"31163007661175","10532.71","14.98","EURd","TRADE","PROCESSED","2023-06-13 13:36:10","00513301-0055-311e-0000-4c41000c4ab1_00513301-0055-311e-0000-0000807ab07c","TSLA","Tesla Inc (Extended Hours)","",""
"31162944745867","10517.73","0.11","EURd","TRADE","PROCESSED","2023-06-13 13:35:10","0004140c-0055-311e-0000-4c41000c3b3f_0004140c-0055-311e-0000-0000804d822f","AAPL","Apple Inc (Extended Hours)","",""
"31159406851504","10517.62","21.69","EURd","TRADE","PROCESSED","2023-06-13 12:38:56","0015421d-0055-311e-0000-4c410005ffb9_0015421d-0055-311e-0000-000080db242c","ETH/USD","Ethereum / USD","",""
"31156113274518","10495.93","10.28","EURd","TRADE","PROCESSED","2023-06-13 11:46:35","00018509-0055-311e-0000-4c4100084656_00018509-0055-311e-0000-0000811c34e8","Oil - Crude","Crude Oil","",""
"31102157735636","10485.65","-0.13","EURd","SWAP","PROCESSED","2023-06-12 21:28:59","","Oil - Crude","Crude Oil","",""
"31096761771667","10485.78","0.56","EURd","TRADE","PROCESSED","2023-06-12 20:03:13","00016258-0055-311e-0000-4c4000255510_00016258-0055-311e-0000-000080493932","VIX","Volatility Index","",""
"31095235048174","10485.22","-5.95","EURd","TRADE","PROCESSED","2023-06-12 19:38:57","00081081-0055-311e-0000-4c4000275f60_00081081-0055-311e-0000-0000801ea144","BABA","Alibaba Group Holding Limited (Extended Hours)","",""
"31095235048173","10491.17","1.17","EURd","TRADE","PROCESSED","2023-06-12 19:38:57","00081081-0055-311e-0000-4c4000275f5f_00081081-0055-311e-0000-0000801eb031","BABA","Alibaba Group Holding Limited (Extended Hours)","",""
"31095233999596","10490","-8.31","EURd","TRADE","PROCESSED","2023-06-12 19:38:56","00081081-0055-311e-0000-4c4000275f5e_00081081-0055-311e-0000-0000801e9b79","BABA","Alibaba Group Holding Limited (Extended Hours)","",""
"31095233999595","10498.31","-3.81","EURd","TRADE","PROCESSED","2023-06-12 19:38:56","00081081-0055-311e-0000-4c4000275f5d_00081081-0055-311e-0000-0000801ea0bb","BABA","Alibaba Group Holding Limited (Extended Hours)","",""
"31095233999593","10502.12","-0.8","EURd","TRADE","PROCESSED","2023-06-12 19:38:56","00081081-0055-311e-0000-4c4000275f5c_00081081-0055-311e-0000-0000801e9ce6","BABA","Alibaba Group Holding Limited (Extended Hours)","",""
"31095233999590","10502.92","-3.99","EURd","TRADE","PROCESSED","2023-06-12 19:38:56","00081081-0055-311e-0000-4c4000275f5b_00081081-0055-311e-0000-0000801e9ce9","BABA","Alibaba Group Holding Limited (Extended Hours)","",""
"31095233999589","10506.91","-8.14","EURd","TRADE","PROCESSED","2023-06-12 19:38:56","00081081-0055-311e-0000-4c4000275f5a_00081081-0055-311e-0000-0000801e9b7e","BABA","Alibaba Group Holding Limited (Extended Hours)","",""
"31055845292169","10515.05","0.32","EURd","TRADE","PROCESSED","2023-06-12 09:12:52","00353194-0055-311e-0000-4c4000012a18_00353194-0055-311e-0000-0000801e4596","MSFT","Microsoft Corp (Extended Hours)","",""
"31011891079649","10514.73","-1.53","EURd","SWAP","PROCESSED","2023-06-11 21:34:14","","VIX","Volatility Index","",""
"30921215471762","10516.26","-1.53","EURd","SWAP","PROCESSED","2023-06-10 21:32:59","","VIX","Volatility Index","",""
"30830585987740","10517.79","-1.53","EURd","SWAP","PROCESSED","2023-06-09 21:32:28","","VIX","Volatility Index","",""
"30739949185728","10519.32","-1.71","EURd","SWAP","PROCESSED","2023-06-08 21:31:50","","VIX","Volatility Index","",""
"30649490622955","10521.03","-1.72","EURd","SWAP","PROCESSED","2023-06-07 21:34:02","","VIX","Volatility Index","",""
"30620123161136","10522.75","6.35","EURd","TRADE","PROCESSED","2023-06-07 13:47:15","00513301-0055-311e-0000-4c3b000bc54f_00513301-0055-311e-0000-0000807a118c","TSLA","Tesla Inc (Extended Hours)","",""
"30620123161133","10516.4","16.17","EURd","TRADE","PROCESSED","2023-06-07 13:47:15","00513301-0055-311e-0000-4c3b000bc54e_00513301-0055-311e-0000-0000807a0e8d","TSLA","Tesla Inc (Extended Hours)","",""
"30550879403181","10500.23","5.81","EURd","TRADE","PROCESSED","2023-06-06 19:26:39","0004140c-0055-311e-0000-4c3a00141924_0004140c-0055-311e-0000-0000804d59a2","AAPL","Apple Inc (Extended Hours)","",""
"30550879403180","10494.42","2.22","EURd","TRADE","PROCESSED","2023-06-06 19:26:39","0004140c-0055-311e-0000-4c3a0014191f_0004140c-0055-311e-0000-0000804d599d","AAPL","Apple Inc (Extended Hours)","",""
"30550721067491","10492.2","50.1","EURd","TRADE","PROCESSED","2023-06-06 19:24:08","000940dd-0055-311e-0000-4c3a00140426_000940dd-0055-311e-0000-00008195034e","BTC/USD","Bitcoin / USD","",""
"30530583155984","10442.1","11.25","EURd","TRADE","PROCESSED","2023-06-06 14:04:03","0015421d-0055-311e-0000-4c3a0004ef46_0015421d-0055-311e-0000-000080d9fd60","ETH/USD","Ethereum / USD","",""
"30530583155983","10430.85","11.13","EURd","TRADE","PROCESSED","2023-06-06 14:04:03","0015421d-0055-311e-0000-4c3a0004ef45_0015421d-0055-311e-0000-000080d9fd63","ETH/USD","Ethereum / USD","",""
"30523489541804","10419.72","-3.37","EURd","TRADE","PROCESSED","2023-06-06 12:11:18","0015421d-0055-311e-0000-4c3a0003619b_0015421d-0055-311e-0000-000080d9f357","ETH/USD","Ethereum / USD","",""
"30523489541800","10423.09","-3.3","EURd","TRADE","PROCESSED","2023-06-06 12:11:18","0015421d-0055-311e-0000-4c3a00036196_0015421d-0055-311e-0000-000080d9f3a9","ETH/USD","Ethereum / USD","",""
"30458245053270","10426.39","-10.98","EURd","TRADE","PROCESSED","2023-06-05 18:54:16","000940dd-0055-311e-0000-4c390014f0d5_000940dd-0055-311e-0000-00008194ed96","BTC/USD","Bitcoin / USD","",""
"30452873185370","10437.37","-8.16","EURd","TRADE","PROCESSED","2023-06-05 17:28:53","000940dd-0055-311e-0000-4c39001261ae_000940dd-0055-311e-0000-00008194f1d3","BTC/USD","Bitcoin / USD","",""
"30450417424715","10445.53","-37.31","EURd","TRADE","PROCESSED","2023-06-05 16:49:51","00001344-0055-311e-0000-4c39001c3dd6_00001344-0055-311e-0000-0000801e2353","AMD","Advanced Micro Devices Inc (Extended Hours)","",""
"30450417424714","10482.84","-37.42","EURd","TRADE","PROCESSED","2023-06-05 16:49:51","00001344-0055-311e-0000-4c39001c3dd5_00001344-0055-311e-0000-0000801e234d","AMD","Advanced Micro Devices Inc (Extended Hours)","",""
"30450417424713","10520.26","-9.62","EURd","TRADE","PROCESSED","2023-06-05 16:49:51","00001344-0055-311e-0000-4c39001c3dd4_00001344-0055-311e-0000-0000801e234a","AMD","Advanced Micro Devices Inc (Extended Hours)","",""
"30447719438919","10529.88","1.54","EURd","TRADE","PROCESSED","2023-06-05 16:06:58","00001344-0055-311e-0000-4c3900190571_00001344-0055-311e-0000-0000801e2ec9","AMD","Advanced Micro Devices Inc (Extended Hours)","",""
"30447712098794","10528.34","22.39","EURd","TRADE","PROCESSED","2023-06-05 16:06:51","00081081-0055-311e-0000-4c390019031f_00081081-0055-311e-0000-0000801ea6a5","BABA","Alibaba Group Holding Limited (Extended Hours)","",""
"30447689029852","10505.95","26.82","EURd","TRADE","PROCESSED","2023-06-05 16:06:29","000940dd-0055-311e-0000-4c3900103401_000940dd-0055-311e-0000-00008194e5b4","BTC/USD","Bitcoin / USD","",""
"30447681689678","10479.13","-9.41","EURd","TRADE","PROCESSED","2023-06-05 16:06:22","000940dd-0055-311e-0000-4c39001032e1_000940dd-0055-311e-0000-00008194eb7a","BTC/USD","Bitcoin / USD","",""
"30165599018657","10488.54","1.67","EURd","TRADE","PROCESSED","2023-06-02 13:22:47","00018509-0055-311e-0000-4c36000d692f_00018509-0055-311e-0000-00008117ed65","Oil - Crude","Crude Oil","",""
"30106293654361","10486.87","-0.14","EURd","SWAP","PROCESSED","2023-06-01 21:40:09","","Oil - Crude","Crude Oil","",""
"30014309432494","10487.01","-0.14","EURd","SWAP","PROCESSED","2023-05-31 21:18:06","","Oil - Crude","Crude Oil","",""
"29983789571415","10487.15","13.76","EURd","TRADE","PROCESSED","2023-05-31 13:13:00","00018387-0055-311e-0000-4c34000c4fe8_00018387-0055-311e-0000-000080d1a964","Natural Gas","Natural Gas","",""
"29983789571414","10473.39","2.71","EURd","TRADE","PROCESSED","2023-05-31 13:13:00","00018387-0055-311e-0000-4c34000c4fe7_00018387-0055-311e-0000-000080d19e9f","Natural Gas","Natural Gas","",""
"29983789571413","10470.68","0.52","EURd","TRADE","PROCESSED","2023-05-31 13:13:00","00018387-0055-311e-0000-4c34000c4fe6_00018387-0055-311e-0000-000080d19e74","Natural Gas","Natural Gas","",""
"29983789571412","10470.16","7.33","EURd","TRADE","PROCESSED","2023-05-31 13:13:00","00018387-0055-311e-0000-4c34000c4fe5_00018387-0055-311e-0000-000080d19e71","Natural Gas","Natural Gas","",""
"29983789571411","10462.83","-3.26","EURd","TRADE","PROCESSED","2023-05-31 13:13:00","00018387-0055-311e-0000-4c34000c4fe4_00018387-0055-311e-0000-000080d1637f","Natural Gas","Natural Gas","",""
"29983789571410","10466.09","12.64","EURd","TRADE","PROCESSED","2023-05-31 13:13:00","00018387-0055-311e-0000-4c34000c4fe3_00018387-0055-311e-0000-000080d1a3cb","Natural Gas","Natural Gas","",""
"29983789571409","10453.45","19.47","EURd","TRADE","PROCESSED","2023-05-31 13:13:00","00018387-0055-311e-0000-4c34000c4fe2_00018387-0055-311e-0000-000080d1df04","Natural Gas","Natural Gas","",""
"29924125595855","10433.98","-0.56","EURd","SWAP","PROCESSED","2023-05-30 21:24:40","","Natural Gas","Natural Gas","",""
"29924120351634","10434.54","-0.83","EURd","SWAP","PROCESSED","2023-05-30 21:24:35","","Natural Gas","Natural Gas","",""
"29924119302888","10435.37","-0.83","EURd","SWAP","PROCESSED","2023-05-30 21:24:34","","Natural Gas","Natural Gas","",""
"29924117205368","10436.2","-0.28","EURd","SWAP","PROCESSED","2023-05-30 21:24:32","","Natural Gas","Natural Gas","",""
"29924117205335","10436.48","-0.06","EURd","SWAP","PROCESSED","2023-05-30 21:24:32","","Natural Gas","Natural Gas","",""
"29924117205320","10436.54","-0.8","EURd","SWAP","PROCESSED","2023-05-30 21:24:32","","Natural Gas","Natural Gas","",""
"29924113010105","10437.34","-0.8","EURd","SWAP","PROCESSED","2023-05-30 21:24:28","","Natural Gas","Natural Gas","",""
"29923347547993","10438.14","-0.1","EURd","SWAP","PROCESSED","2023-05-30 21:12:18","","Oil - Crude","Crude Oil","",""
"29884495712523","10438.24","4.57","EURd","TRADE","PROCESSED","2023-05-30 10:54:46","00018509-0055-311e-0000-4c330009a768_00018509-0055-311e-0000-00008117e6fe","Oil - Crude","Crude Oil","",""
"29877932677676","10433.67","6.54","EURd","TRADE","PROCESSED","2023-05-30 09:10:27","0024e503-0055-311e-0000-4c330001d211_0024e503-0055-311e-0000-0000801d5121","INTC","Intel Corp (Extended Hours)","",""
"29877557284768","10427.13","1.12","EURd","TRADE","PROCESSED","2023-05-30 09:04:29","0024e503-0055-311e-0000-4c330001cb51_0024e503-0055-311e-0000-0000801d4ce9","INTC","Intel Corp (Extended Hours)","",""
"29833250756809","10426.01","-0.81","EURd","SWAP","PROCESSED","2023-05-29 21:20:15","","Natural Gas","Natural Gas","",""
"29833247610482","10426.82","-0.81","EURd","SWAP","PROCESSED","2023-05-29 21:20:12","","Natural Gas","Natural Gas","",""
"29833243415387","10427.63","-0.27","EURd","SWAP","PROCESSED","2023-05-29 21:20:08","","Natural Gas","Natural Gas","",""
"29833243415356","10427.9","-0.06","EURd","SWAP","PROCESSED","2023-05-29 21:20:08","","Natural Gas","Natural Gas","",""
"29833243415335","10427.96","-0.78","EURd","SWAP","PROCESSED","2023-05-29 21:20:08","","Natural Gas","Natural Gas","",""
"29833235024907","10428.74","-0.78","EURd","SWAP","PROCESSED","2023-05-29 21:20:00","","Natural Gas","Natural Gas","",""
"29820318676961","10429.52","-10.02","EURd","TRADE","PROCESSED","2023-05-29 17:54:42","000940dd-0055-311e-0000-4c32000c3268_000940dd-0055-311e-0000-00008193ad21","BTC/USD","Bitcoin / USD","",""
"29745118987264","10439.54","9.7","EURd","TRADE","PROCESSED","2023-05-28 21:59:26","000940dd-0055-311e-0000-4c3100060797_000940dd-0055-311e-0000-0000819374af","BTC/USD","Bitcoin / USD","",""
"29744249731279","10429.84","12.33","EURd","TRADE","PROCESSED","2023-05-28 21:45:37","0015421d-0055-311e-0000-4c3100069e3d_0015421d-0055-311e-0000-000080d96fad","ETH/USD","Ethereum / USD","",""
"29742465056186","10417.51","-0.75","EURd","SWAP","PROCESSED","2023-05-28 21:17:15","","Natural Gas","Natural Gas","",""
"29731478067930","10418.26","13.64","EURd","TRADE","PROCESSED","2023-05-28 18:22:37","0015421d-0055-311e-0000-4c31000565c9_0015421d-0055-311e-0000-000080d95612","ETH/USD","Ethereum / USD","",""
"29731478067929","10404.62","10.53","EURd","TRADE","PROCESSED","2023-05-28 18:22:37","0015421d-0055-311e-0000-4c31000565c8_0015421d-0055-311e-0000-000080d94f84","ETH/USD","Ethereum / USD","",""
"29731461290230","10394.09","35.3","EURd","TRADE","PROCESSED","2023-05-28 18:22:21","000940dd-0055-311e-0000-4c310004a346_000940dd-0055-311e-0000-000081930d8c","BTC/USD","Bitcoin / USD","",""
"29676915412621","10358.79","13.48","EURd","TRADE","PROCESSED","2023-05-28 03:55:22","000940dd-0055-311e-0000-4c3100012873_000940dd-0055-311e-0000-00008192b692","BTC/USD","Bitcoin / USD","",""
"29676915412616","10345.31","21.77","EURd","TRADE","PROCESSED","2023-05-28 03:55:22","000940dd-0055-311e-0000-4c3100012872_000940dd-0055-311e-0000-0000819298af","BTC/USD","Bitcoin / USD","",""
"29652453186052","10323.54","-0.75","EURd","SWAP","PROCESSED","2023-05-27 21:26:32","","Natural Gas","Natural Gas","",""
"29561845741858","10324.29","-0.75","EURd","SWAP","PROCESSED","2023-05-26 21:26:23","","Natural Gas","Natural Gas","",""
"29555134852015","10325.04","2.94","EURd","TRADE","PROCESSED","2023-05-26 19:39:43","0015421d-0055-311e-0000-4c2f0007f52b_0015421d-0055-311e-0000-000080d92ad7","ETH/USD","Ethereum / USD","",""
"29555134852014","10322.1","10.38","EURd","TRADE","PROCESSED","2023-05-26 19:39:43","0015421d-0055-311e-0000-4c2f0007f52a_0015421d-0055-311e-0000-000080d92ada","ETH/USD","Ethereum / USD","",""
"29555134852013","10311.72","17.23","EURd","TRADE","PROCESSED","2023-05-26 19:39:43","0015421d-0055-311e-0000-4c2f0007f529_0015421d-0055-311e-0000-000080d93060","ETH/USD","Ethereum / USD","",""
"29555134852011","10294.49","21.73","EURd","TRADE","PROCESSED","2023-05-26 19:39:43","0015421d-0055-311e-0000-4c2f0007f528_0015421d-0055-311e-0000-000080d937fa","ETH/USD","Ethereum / USD","",""
"29543727382647","10272.76","5.82","EURd","TRADE","PROCESSED","2023-05-26 16:38:24","004433cd-0055-311e-0000-4c2f001bf507_004433cd-0055-311e-0000-0000801d0981","QCOM","QUALCOMM Inc (Extended Hours)","",""
"29534586947401","10266.94","5.03","EURd","TRADE","PROCESSED","2023-05-26 14:13:07","004433cd-0055-311e-0000-4c2f000afddc_004433cd-0055-311e-0000-0000801d0995","QCOM","QUALCOMM Inc (Extended Hours)","",""
"29452167823446","10261.91","-3.36","EURd","TRADE","PROCESSED","2023-05-25 16:23:06","00081081-0055-311e-0000-4c2e002016ad_00081081-0055-311e-0000-0000801ea73e","BABA","Alibaba Group Holding Limited (Extended Hours)","",""
"29442830260513","10265.27","0","EURd","TRADE","PROCESSED","2023-05-25 13:54:41","00353194-0055-311e-0000-4c2e000a8bc7_00353194-0055-311e-0000-0000801e272a","MSFT","Microsoft Corp (Extended Hours)","",""
"29377123340641","10265.27","5.36","EURd","TRADE","PROCESSED","2023-05-24 20:30:18","00018387-0055-311e-0000-4c2d0029bdf3_00018387-0055-311e-0000-000080d04139","Natural Gas","Natural Gas","",""
"29377123340640","10259.91","8.79","EURd","TRADE","PROCESSED","2023-05-24 20:30:18","00018387-0055-311e-0000-4c2d0029bdf2_00018387-0055-311e-0000-000080d06792","Natural Gas","Natural Gas","",""
"29377123340639","10251.12","5.86","EURd","TRADE","PROCESSED","2023-05-24 20:30:18","00018387-0055-311e-0000-4c2d0029bdf1_00018387-0055-311e-0000-000080d02ad4","Natural Gas","Natural Gas","",""
"29330837101596","10245.26","-2.59","EURd","TRADE","PROCESSED","2023-05-24 08:14:36","00601567-0055-311e-0000-4c2d0005f029_00601567-0055-311e-0000-00008111cabd","Gold","Gold","",""
"29330837101595","10247.85","-3.33","EURd","TRADE","PROCESSED","2023-05-24 08:14:36","00601567-0055-311e-0000-4c2d0005f028_00601567-0055-311e-0000-00008111a37d","Gold","Gold","",""
"29330837101594","10251.18","-3.82","EURd","TRADE","PROCESSED","2023-05-24 08:14:36","00601567-0055-311e-0000-4c2d0005f027_00601567-0055-311e-0000-000081119be6","Gold","Gold","",""
"29330837101593","10255","-3.97","EURd","TRADE","PROCESSED","2023-05-24 08:14:36","00601567-0055-311e-0000-4c2d0005f026_00601567-0055-311e-0000-000081119bb0","Gold","Gold","",""
"29330837101592","10258.97","-1.36","EURd","TRADE","PROCESSED","2023-05-24 08:14:36","00601567-0055-311e-0000-4c2d0005f025_00601567-0055-311e-0000-00008111d3af","Gold","Gold","",""
"29330837101590","10260.33","-2.75","EURd","TRADE","PROCESSED","2023-05-24 08:14:36","00601567-0055-311e-0000-4c2d0005f024_00601567-0055-311e-0000-000081120147","Gold","Gold","",""
"29330837101589","10263.08","-1.31","EURd","TRADE","PROCESSED","2023-05-24 08:14:36","00601567-0055-311e-0000-4c2d0005f023_00601567-0055-311e-0000-000081120033","Gold","Gold","",""
"29330837101588","10264.39","-0.65","EURd","TRADE","PROCESSED","2023-05-24 08:14:36","00601567-0055-311e-0000-4c2d0005f022_00601567-0055-311e-0000-000081142fb9","Gold","Gold","",""
"29291062511902","10265.04","-0.04","EURd","SWAP","PROCESSED","2023-05-23 21:42:24","","Gold","Gold","",""
"29291028967015","10265.08","-0.14","EURd","SWAP","PROCESSED","2023-05-23 21:41:52","","Gold","Gold","",""
"29291027918421","10265.22","-0.07","EURd","SWAP","PROCESSED","2023-05-23 21:41:51","","Gold","Gold","",""
"29291024772155","10265.29","-0.07","EURd","SWAP","PROCESSED","2023-05-23 21:41:48","","Gold","Gold","",""
"29291024772067","10265.36","-0.1","EURd","SWAP","PROCESSED","2023-05-23 21:41:48","","Gold","Gold","",""
"29291021625831","10265.46","-0.1","EURd","SWAP","PROCESSED","2023-05-23 21:41:45","","Gold","Gold","",""
"29291021625742","10265.56","-0.1","EURd","SWAP","PROCESSED","2023-05-23 21:41:45","","Gold","Gold","",""
"29291021625728","10265.66","-0.1","EURd","SWAP","PROCESSED","2023-05-23 21:41:45","","Gold","Gold","",""
"29289039814229","10265.76","-0.8","EURd","SWAP","PROCESSED","2023-05-23 21:10:15","","Natural Gas","Natural Gas","",""
"29289031423979","10266.56","-0.43","EURd","SWAP","PROCESSED","2023-05-23 21:10:07","","Natural Gas","Natural Gas","",""
"29289023033467","10266.99","-1.6","EURd","SWAP","PROCESSED","2023-05-23 21:09:59","","Natural Gas","Natural Gas","",""
"29268727845549","10268.59","0.58","EURd","TRADE","PROCESSED","2023-05-23 15:47:24","00601567-0055-311e-0000-4c2c00183646_00601567-0055-311e-0000-000081151973","Gold","Gold","",""
"29263656939959","10268.01","12.05","EURd","TRADE","PROCESSED","2023-05-23 14:26:48","00000006-0055-311e-0000-4c2c000bc1a7_00000006-0055-311e-0000-0000801d2fd7","F","Ford Motor Co (Extended Hours)","",""
"29263656939958","10255.96","0.75","EURd","TRADE","PROCESSED","2023-05-23 14:26:48","00000006-0055-311e-0000-4c2c000bc1a6_00000006-0055-311e-0000-0000801d2fb8","F","Ford Motor Co (Extended Hours)","",""
"29263656939957","10255.21","7.88","EURd","TRADE","PROCESSED","2023-05-23 14:26:48","00000006-0055-311e-0000-4c2c000bc1a5_00000006-0055-311e-0000-0000801d300f","F","Ford Motor Co (Extended Hours)","",""
"29239941294439","10247.33","0.05","EURd","TRADE","PROCESSED","2023-05-23 08:09:51","00601567-0055-311e-0000-4c2c00062387_00601567-0055-311e-0000-000081153476","Gold","Gold","",""
"29229185003505","10247.28","21.44","EURd","TRADE","PROCESSED","2023-05-23 05:18:53","000940dd-0055-311e-0000-4c2c0003ea44_000940dd-0055-311e-0000-000081925b8b","BTC/USD","Bitcoin / USD","",""
"29198675627254","10225.84","-0.04","EURd","SWAP","PROCESSED","2023-05-22 21:13:57","","Gold","Gold","",""
"29198626349144","10225.88","-0.14","EURd","SWAP","PROCESSED","2023-05-22 21:13:10","","Gold","Gold","",""
"29198626349124","10226.02","-0.07","EURd","SWAP","PROCESSED","2023-05-22 21:13:10","","Gold","Gold","",""
"29198623202589","10226.09","-0.07","EURd","SWAP","PROCESSED","2023-05-22 21:13:07","","Gold","Gold","",""
"29198622153728","10226.16","-0.11","EURd","SWAP","PROCESSED","2023-05-22 21:13:06","","Gold","Gold","",""
"29198616909707","10226.27","-0.11","EURd","SWAP","PROCESSED","2023-05-22 21:13:01","","Gold","Gold","",""
"29198614812131","10226.38","-0.11","EURd","SWAP","PROCESSED","2023-05-22 21:12:59","","Gold","Gold","",""
"29198614812088","10226.49","-0.11","EURd","SWAP","PROCESSED","2023-05-22 21:12:59","","Gold","Gold","",""
"29190208377148","10226.6","63.59","EURd","TRADE","PROCESSED","2023-05-22 18:59:22","00513301-0055-311e-0000-4c2b00145e03_00513301-0055-311e-0000-000080788fb7","TSLA","Tesla Inc (Extended Hours)","",""
"29173596841338","10163.01","5.46","EURd","TRADE","PROCESSED","2023-05-22 14:35:20","0041940c-0055-311e-0000-4c2b000fa4e9_0041940c-0055-311e-0000-0000801d53d6","PYPL","PayPal Holdings (Extended Hours)","",""
"29173596841337","10157.55","9.62","EURd","TRADE","PROCESSED","2023-05-22 14:35:20","0041940c-0055-311e-0000-4c2b000fa4e8_0041940c-0055-311e-0000-0000801d54ec","PYPL","PayPal Holdings (Extended Hours)","",""
"29173596841336","10147.93","9.62","EURd","TRADE","PROCESSED","2023-05-22 14:35:20","0041940c-0055-311e-0000-4c2b000fa4e7_0041940c-0055-311e-0000-0000801d54e9","PYPL","PayPal Holdings (Extended Hours)","",""
"29173596841335","10138.31","10.36","EURd","TRADE","PROCESSED","2023-05-22 14:35:20","0041940c-0055-311e-0000-4c2b000fa4e6_0041940c-0055-311e-0000-0000801d538a","PYPL","PayPal Holdings (Extended Hours)","",""
"29170779309081","10127.95","5.4","EURd","TRADE","PROCESSED","2023-05-22 13:50:33","073cf1cc-0055-311e-0000-4c2b0006dfe1_073cf1cc-0055-311e-0000-0000801d472a","GOOGL","Alphabet Inc - A (Extended Hours)","",""
"29170266566978","10122.55","4.74","EURd","TRADE","PROCESSED","2023-05-22 13:42:24","00000182-0055-311e-0000-4c2b000b5b02_00000182-0055-311e-0000-0000804857e8","META","Meta Platforms Inc (Extended Hours)","",""
"29170265518393","10117.81","10.5","EURd","TRADE","PROCESSED","2023-05-22 13:42:23","00000182-0055-311e-0000-4c2b000b5b01_00000182-0055-311e-0000-0000804856b5","META","Meta Platforms Inc (Extended Hours)","",""
"29108173042957","10107.31","-0.04","EURd","SWAP","PROCESSED","2023-05-21 21:15:27","","Gold","Gold","",""
"29108120601611","10107.35","-0.14","EURd","SWAP","PROCESSED","2023-05-21 21:14:37","","Gold","Gold","",""
"29108120601594","10107.49","-0.07","EURd","SWAP","PROCESSED","2023-05-21 21:14:37","","Gold","Gold","",""
"29108117455074","10107.56","-0.07","EURd","SWAP","PROCESSED","2023-05-21 21:14:34","","Gold","Gold","",""
"29108116406322","10107.63","-0.1","EURd","SWAP","PROCESSED","2023-05-21 21:14:33","","Gold","Gold","",""
"29108112227219","10107.73","-0.1","EURd","SWAP","PROCESSED","2023-05-21 21:14:29","","Gold","Gold","",""
"29108111178442","10107.83","-0.1","EURd","SWAP","PROCESSED","2023-05-21 21:14:28","","Gold","Gold","",""
"29108111178397","10107.93","-0.1","EURd","SWAP","PROCESSED","2023-05-21 21:14:28","","Gold","Gold","",""
"29017564536354","10108.03","-0.04","EURd","SWAP","PROCESSED","2023-05-20 21:15:16","","Gold","Gold","",""
"29017514208860","10108.07","-0.14","EURd","SWAP","PROCESSED","2023-05-20 21:14:28","","Gold","Gold","",""
"29017514208845","10108.21","-0.07","EURd","SWAP","PROCESSED","2023-05-20 21:14:28","","Gold","Gold","",""
"29017512110919","10108.28","-0.07","EURd","SWAP","PROCESSED","2023-05-20 21:14:26","","Gold","Gold","",""
"29017511062178","10108.35","-0.1","EURd","SWAP","PROCESSED","2023-05-20 21:14:25","","Gold","Gold","",""
"29017506866732","10108.45","-0.1","EURd","SWAP","PROCESSED","2023-05-20 21:14:21","","Gold","Gold","",""
"29017505817958","10108.55","-0.1","EURd","SWAP","PROCESSED","2023-05-20 21:14:20","","Gold","Gold","",""
"29017505817925","10108.65","-0.1","EURd","SWAP","PROCESSED","2023-05-20 21:14:20","","Gold","Gold","",""
"28926676073782","10108.75","-0.04","EURd","SWAP","PROCESSED","2023-05-19 21:10:38","","Gold","Gold","",""
"28926625730053","10108.79","-0.14","EURd","SWAP","PROCESSED","2023-05-19 21:09:50","","Gold","Gold","",""
"28926625730037","10108.93","-0.07","EURd","SWAP","PROCESSED","2023-05-19 21:09:50","","Gold","Gold","",""
"28926622583522","10109","-0.07","EURd","SWAP","PROCESSED","2023-05-19 21:09:47","","Gold","Gold","",""
"28926621534774","10109.07","-0.1","EURd","SWAP","PROCESSED","2023-05-19 21:09:46","","Gold","Gold","",""
"28926617339368","10109.17","-0.1","EURd","SWAP","PROCESSED","2023-05-19 21:09:42","","Gold","Gold","",""
"28926616290586","10109.27","-0.1","EURd","SWAP","PROCESSED","2023-05-19 21:09:41","","Gold","Gold","",""
"28926616290551","10109.37","-0.1","EURd","SWAP","PROCESSED","2023-05-19 21:09:41","","Gold","Gold","",""
"28899889138471","10109.47","0.01","EURd","TRADE","PROCESSED","2023-05-19 14:04:52","0015421d-0055-311e-0000-4c2800069a1f_0015421d-0055-311e-0000-000080d8d1b5","ETH/USD","Ethereum / USD","",""
"28897139785611","10109.46","2.02","EURd","TRADE","PROCESSED","2023-05-19 13:21:10","0015421d-0055-311e-0000-4c280006312e_0015421d-0055-311e-0000-000080d8d1b2","ETH/USD","Ethereum / USD","",""
"28887782291573","10107.44","-0.88","EURd","TRADE","PROCESSED","2023-05-19 10:52:26","00601567-0055-311e-0000-4c280007d971_00601567-0055-311e-0000-000081133eeb","Gold","Gold","",""
"28886444305361","10108.32","-6.89","EURd","TRADE","PROCESSED","2023-05-19 10:31:10","00001344-0055-311e-0000-4c280000fd4f_00001344-0055-311e-0000-0000801dfcd6","AMD","Advanced Micro Devices Inc (Extended Hours)","",""
"28886434868156","10115.21","-1.98","EURd","TRADE","PROCESSED","2023-05-19 10:31:01","00001344-0055-311e-0000-4c280000fd10_00001344-0055-311e-0000-0000801dfcdd","AMD","Advanced Micro Devices Inc (Extended Hours)","",""
"28868364754753","10117.19","-1.27","EURd","TRADE","PROCESSED","2023-05-19 05:43:48","00601567-0055-311e-0000-4c2800036842_00601567-0055-311e-0000-000081133f2c","Gold","Gold","",""
"28868362657598","10118.46","-1.28","EURd","TRADE","PROCESSED","2023-05-19 05:43:46","00601567-0055-311e-0000-4c2800036819_00601567-0055-311e-0000-000081133f2f","Gold","Gold","",""
"28868310228705","10119.74","-1.17","EURd","TRADE","PROCESSED","2023-05-19 05:42:56","00601567-0055-311e-0000-4c2800036658_00601567-0055-311e-0000-0000811345d4","Gold","Gold","",""
"28868307082975","10120.91","-1.27","EURd","TRADE","PROCESSED","2023-05-19 05:42:53","00601567-0055-311e-0000-4c280003664c_00601567-0055-311e-0000-000081133f32","Gold","Gold","",""
"28836027727075","10122.18","-0.04","EURd","SWAP","PROCESSED","2023-05-18 21:09:49","","Gold","Gold","",""
"28836025629288","10122.22","-0.04","EURd","SWAP","PROCESSED","2023-05-18 21:09:47","","Gold","Gold","",""
"28836025629267","10122.26","-0.04","EURd","SWAP","PROCESSED","2023-05-18 21:09:47","","Gold","Gold","",""
"28836025629250","10122.3","-0.04","EURd","SWAP","PROCESSED","2023-05-18 21:09:47","","Gold","Gold","",""
"28836025629231","10122.34","-0.04","EURd","SWAP","PROCESSED","2023-05-18 21:09:47","","Gold","Gold","",""
"28836003603855","10122.38","-0.14","EURd","SWAP","PROCESSED","2023-05-18 21:09:26","","Gold","Gold","",""
"28836003603841","10122.52","-0.07","EURd","SWAP","PROCESSED","2023-05-18 21:09:26","","Gold","Gold","",""
"28835999408451","10122.59","-0.07","EURd","SWAP","PROCESSED","2023-05-18 21:09:22","","Gold","Gold","",""
"28835998359657","10122.66","-0.11","EURd","SWAP","PROCESSED","2023-05-18 21:09:21","","Gold","Gold","",""
"28835992066755","10122.77","-0.11","EURd","SWAP","PROCESSED","2023-05-18 21:09:15","","Gold","Gold","",""
"28835991017973","10122.88","-0.11","EURd","SWAP","PROCESSED","2023-05-18 21:09:14","","Gold","Gold","",""
"28835991017941","10122.99","-0.11","EURd","SWAP","PROCESSED","2023-05-18 21:09:14","","Gold","Gold","",""
"28830732417368","10123.1","0.15","EURd","TRADE","PROCESSED","2023-05-18 19:45:39","00001344-0055-311e-0000-4c27002bf1d2_00001344-0055-311e-0000-0000801dfcae","AMD","Advanced Micro Devices Inc (Extended Hours)","",""
"28830050839214","10122.95","5.11","EURd","TRADE","PROCESSED","2023-05-18 19:34:49","0000a40d-0055-311e-0000-4c27002ad01b_0000a40d-0055-311e-0000-0000801d1319","JPM","JPMorgan Chase & Co (Extended Hours)","",""
"28818360260992","10117.84","-3.67","EURd","TRADE","PROCESSED","2023-05-18 16:29:00","006011e7-0055-311e-0000-4c27001aef3d_006011e7-0055-311e-0000-0000805c02a9","Silver","Silver","",""
"28818360260991","10121.51","-3.92","EURd","TRADE","PROCESSED","2023-05-18 16:29:00","006011e7-0055-311e-0000-4c27001aef3c_006011e7-0055-311e-0000-0000805c029d","Silver","Silver","",""
"28814545551302","10125.43","1.81","EURd","TRADE","PROCESSED","2023-05-18 15:28:22","00081081-0055-311e-0000-4c270013cfb5_00081081-0055-311e-0000-0000801e9c0d","BABA","Alibaba Group Holding Limited (Extended Hours)","",""
"28814540308386","10123.62","3.9","EURd","TRADE","PROCESSED","2023-05-18 15:28:17","00081081-0055-311e-0000-4c270013cdc8_00081081-0055-311e-0000-0000801e9c53","BABA","Alibaba Group Holding Limited (Extended Hours)","",""
"28814537162645","10119.72","6.41","EURd","TRADE","PROCESSED","2023-05-18 15:28:14","00081081-0055-311e-0000-4c270013cc00_00081081-0055-311e-0000-0000801e9c17","BABA","Alibaba Group Holding Limited (Extended Hours)","",""
"28807794807930","10113.31","5.01","EURd","TRADE","PROCESSED","2023-05-18 13:41:04","00081081-0055-311e-0000-4c27000434bc_00081081-0055-311e-0000-0000801e9bbc","BABA","Alibaba Group Holding Limited (Extended Hours)","",""
"28807767544756","10108.3","0.31","EURd","TRADE","PROCESSED","2023-05-18 13:40:38","00081081-0055-311e-0000-4c2700041e01_00081081-0055-311e-0000-0000801e9b89","BABA","Alibaba Group Holding Limited (Extended Hours)","",""
"28807399505722","10107.99","-2.84","EURd","TRADE","PROCESSED","2023-05-18 13:34:47","00601567-0055-311e-0000-4c27000bce3c_00601567-0055-311e-0000-0000811364e6","Gold","Gold","",""
"28807193982435","10110.83","-0.56","EURd","TRADE","PROCESSED","2023-05-18 13:31:31","00016258-0055-311e-0000-4c27000b5757_00016258-0055-311e-0000-0000804896e4","VIX","Volatility Index","",""
"28807190836671","10111.39","-0.59","EURd","TRADE","PROCESSED","2023-05-18 13:31:28","00016258-0055-311e-0000-4c27000b559d_00016258-0055-311e-0000-000080489685","VIX","Volatility Index","",""
"28807143650033","10111.98","0.74","EURd","TRADE","PROCESSED","2023-05-18 13:30:43","00016258-0055-311e-0000-4c27000b36d4_00016258-0055-311e-0000-000080490132","VIX","Volatility Index","",""
"28806667593310","10111.24","0.1","EURd","TRADE","PROCESSED","2023-05-18 13:23:09","00601567-0055-311e-0000-4c27000ade98_00601567-0055-311e-0000-00008113605c","Gold","Gold","",""
"28806237673402","10111.14","0.63","EURd","TRADE","PROCESSED","2023-05-18 13:16:19","006011e7-0055-311e-0000-4c27000aa0cc_006011e7-0055-311e-0000-0000805c0716","Silver","Silver","",""
"28806233479072","10110.51","-1.39","EURd","TRADE","PROCESSED","2023-05-18 13:16:15","006011e7-0055-311e-0000-4c27000aa037_006011e7-0055-311e-0000-0000805c0885","Silver","Silver","",""
"28806231381905","10111.9","0.58","EURd","TRADE","PROCESSED","2023-05-18 13:16:13","006011e7-0055-311e-0000-4c27000a9fcc_006011e7-0055-311e-0000-0000805c0820","Silver","Silver","",""
"28806229284716","10111.32","0.76","EURd","TRADE","PROCESSED","2023-05-18 13:16:11","006011e7-0055-311e-0000-4c27000a9f64_006011e7-0055-311e-0000-0000805c0825","Silver","Silver","",""
"28805417681355","10110.56","0.05","EURd","TRADE","PROCESSED","2023-05-18 13:03:17","00601567-0055-311e-0000-4c27000a2e71_00601567-0055-311e-0000-0000811355a5","Gold","Gold","",""
"28804541083918","10110.51","1.83","EURd","TRADE","PROCESSED","2023-05-18 12:49:21","006011e7-0055-311e-0000-4c270009a0d6_006011e7-0055-311e-0000-0000805c07d1","Silver","Silver","",""
"28801547399463","10108.68","0.18","EURd","TRADE","PROCESSED","2023-05-18 12:01:46","0024e503-0055-311e-0000-4c270001455d_0024e503-0055-311e-0000-0000801d49cb","INTC","Intel Corp (Extended Hours)","",""
"28801546350886","10108.5","0","EURd","TRADE","PROCESSED","2023-05-18 12:01:45","0024e503-0055-311e-0000-4c270001455c_0024e503-0055-311e-0000-0000801d49d7","INTC","Intel Corp (Extended Hours)","",""
"28801546350885","10108.5","0","EURd","TRADE","PROCESSED","2023-05-18 12:01:45","0024e503-0055-311e-0000-4c270001455b_0024e503-0055-311e-0000-0000801d49d4","INTC","Intel Corp (Extended Hours)","",""
"28800845900107","10108.5","3.03","EURd","TRADE","PROCESSED","2023-05-18 11:50:37","00081081-0055-311e-0000-4c2700013914_00081081-0055-311e-0000-0000801e9ae6","BABA","Alibaba Group Holding Limited (Extended Hours)","",""
"28800293299419","10105.47","4.81","EURd","TRADE","PROCESSED","2023-05-18 11:41:50","00081081-0055-311e-0000-4c2700013094_00081081-0055-311e-0000-0000801e9ae0","BABA","Alibaba Group Holding Limited (Extended Hours)","",""
"28800293299418","10100.66","-1","EURd","TRADE","PROCESSED","2023-05-18 11:41:50","00081081-0055-311e-0000-4c2700013093_00081081-0055-311e-0000-0000801e9ade","BABA","Alibaba Group Holding Limited (Extended Hours)","",""
"28798886106726","10101.66","2.4","EURd","TRADE","PROCESSED","2023-05-18 11:19:28","00081081-0055-311e-0000-4c270001159b_00081081-0055-311e-0000-0000801e9ab2","BABA","Alibaba Group Holding Limited (Extended Hours)","",""
"28798885058141","10099.26","4.21","EURd","TRADE","PROCESSED","2023-05-18 11:19:27","00081081-0055-311e-0000-4c2700011594_00081081-0055-311e-0000-0000801e9ac0","BABA","Alibaba Group Holding Limited (Extended Hours)","",""
"28798863037971","10095.05","2.31","EURd","TRADE","PROCESSED","2023-05-18 11:19:06","00081081-0055-311e-0000-4c27000114fe_00081081-0055-311e-0000-0000801e9aac","BABA","Alibaba Group Holding Limited (Extended Hours)","",""
"28798841017768","10092.74","2.96","EURd","TRADE","PROCESSED","2023-05-18 11:18:45","00081081-0055-311e-0000-4c270001149b_00081081-0055-311e-0000-0000801e9aaf","BABA","Alibaba Group Holding Limited (Extended Hours)","",""
"28798531686912","10089.78","-0.28","EURd","TRADE","PROCESSED","2023-05-18 11:13:50","0024e503-0055-311e-0000-4c2700010e5b_0024e503-0055-311e-0000-0000801d49ce","INTC","Intel Corp (Extended Hours)","",""
"28798474015082","10090.06","-0.58","EURd","TRADE","PROCESSED","2023-05-18 11:12:55","00016258-0055-311e-0000-4c270007d4bf_00016258-0055-311e-0000-000080489688","VIX","Volatility Index","",""
"28798380691439","10090.64","0.69","EURd","TRADE","PROCESSED","2023-05-18 11:11:26","0024e503-0055-311e-0000-4c2700010ad4_0024e503-0055-311e-0000-0000801d49db","INTC","Intel Corp (Extended Hours)","",""
"28798211870220","10089.95","0.92","EURd","TRADE","PROCESSED","2023-05-18 11:08:45","006011e7-0055-311e-0000-4c270007c7b0_006011e7-0055-311e-0000-0000805c0465","Silver","Silver","",""
"28798209773056","10089.03","0.99","EURd","TRADE","PROCESSED","2023-05-18 11:08:43","006011e7-0055-311e-0000-4c270007c77e_006011e7-0055-311e-0000-0000805c045a","Silver","Silver","",""
"28798144761124","10088.04","2.03","EURd","TRADE","PROCESSED","2023-05-18 11:07:41","00081081-0055-311e-0000-4c27000104c5_00081081-0055-311e-0000-0000801e9aa5","BABA","Alibaba Group Holding Limited (Extended Hours)","",""
"28798031514497","10086.01","2.36","EURd","TRADE","PROCESSED","2023-05-18 11:05:53","00081081-0055-311e-0000-4c2700010140_00081081-0055-311e-0000-0000801e9a94","BABA","Alibaba Group Holding Limited (Extended Hours)","",""
"28798031514496","10083.65","0.46","EURd","TRADE","PROCESSED","2023-05-18 11:05:53","00081081-0055-311e-0000-4c270001013f_00081081-0055-311e-0000-0000801e9a7c","BABA","Alibaba Group Holding Limited (Extended Hours)","",""
"28795808542982","10083.19","3.7","EURd","TRADE","PROCESSED","2023-05-18 10:30:33","00018387-0055-311e-0000-4c2700074d8b_00018387-0055-311e-0000-000080cf0dc8","Natural Gas","Natural Gas","",""
"28794509353658","10079.49","0.79","EURd","TRADE","PROCESSED","2023-05-18 10:09:54","006011e7-0055-311e-0000-4c270007130e_006011e7-0055-311e-0000-0000805c045d","Silver","Silver","",""
"28794472653366","10078.7","0.74","EURd","TRADE","PROCESSED","2023-05-18 10:09:19","006011e7-0055-311e-0000-4c27000711a9_006011e7-0055-311e-0000-0000805c0460","Silver","Silver","",""
"28794461118988","10077.96","1.62","EURd","TRADE","PROCESSED","2023-05-18 10:09:08","006011e7-0055-311e-0000-4c2700071132_006011e7-0055-311e-0000-0000805c03b3","Silver","Silver","",""
"28793844554541","10076.34","1.39","EURd","TRADE","PROCESSED","2023-05-18 09:59:20","0024e503-0055-311e-0000-4c270000c22d_0024e503-0055-311e-0000-0000801d49e2","INTC","Intel Corp (Extended Hours)","",""
"28791261905517","10074.95","0.26","EURd","TRADE","PROCESSED","2023-05-18 09:18:17","00601567-0055-311e-0000-4c27000673ec_00601567-0055-311e-0000-000081132b6d","Gold","Gold","",""
"28791258759783","10074.69","0.57","EURd","TRADE","PROCESSED","2023-05-18 09:18:14","00601567-0055-311e-0000-4c27000673e0_00601567-0055-311e-0000-000081132a83","Gold","Gold","",""
"28791256662621","10074.12","1.17","EURd","TRADE","PROCESSED","2023-05-18 09:18:12","00601567-0055-311e-0000-4c27000673bf_00601567-0055-311e-0000-000081132a7b","Gold","Gold","",""
"28787655859755","10072.95","3.05","EURd","TRADE","PROCESSED","2023-05-18 08:20:58","004433cd-0055-311e-0000-4c2700006d38_004433cd-0055-311e-0000-0000801d0959","QCOM","QUALCOMM Inc (Extended Hours)","",""
"28787570924751","10069.9","0.55","EURd","TRADE","PROCESSED","2023-05-18 08:19:37","0024e503-0055-311e-0000-4c2700006bfa_0024e503-0055-311e-0000-0000801d49e7","INTC","Intel Corp (Extended Hours)","",""
"28787525835736","10069.35","0.74","EURd","TRADE","PROCESSED","2023-05-18 08:18:54","0024e503-0055-311e-0000-4c2700006b6e_0024e503-0055-311e-0000-0000801d49fe","INTC","Intel Corp (Extended Hours)","",""
"28787522689991","10068.61","1.66","EURd","TRADE","PROCESSED","2023-05-18 08:18:51","0024e503-0055-311e-0000-4c2700006b5f_0024e503-0055-311e-0000-0000801d4a13","INTC","Intel Corp (Extended Hours)","",""
"28785333265788","10066.95","0.15","EURd","TRADE","PROCESSED","2023-05-18 07:44:03","00601567-0055-311e-0000-4c270004e830_00601567-0055-311e-0000-000081131db6","Gold","Gold","",""
"28746156360334","10066.8","-0.07","EURd","SWAP","PROCESSED","2023-05-17 21:21:21","","Gold","Gold","",""
"28746155311694","10066.87","-0.04","EURd","SWAP","PROCESSED","2023-05-17 21:21:20","","Gold","Gold","",""
"28746143791072","10066.91","-0.04","EURd","SWAP","PROCESSED","2023-05-17 21:21:09","","Gold","Gold","",""
"28746142742151","10066.95","-0.06","EURd","SWAP","PROCESSED","2023-05-17 21:21:08","","Gold","Gold","",""
"28746133302627","10067.01","-0.06","EURd","SWAP","PROCESSED","2023-05-17 21:20:59","","Gold","Gold","",""
"28746132253761","10067.07","-0.06","EURd","SWAP","PROCESSED","2023-05-17 21:20:58","","Gold","Gold","",""
"28746132253732","10067.13","-0.06","EURd","SWAP","PROCESSED","2023-05-17 21:20:58","","Gold","Gold","",""
"28745620540063","10067.19","-0.48","EURd","SWAP","PROCESSED","2023-05-17 21:12:50","","VIX","Volatility Index","",""
"28745619491377","10067.67","-0.06","EURd","SWAP","PROCESSED","2023-05-17 21:12:49","","VIX","Volatility Index","",""
"28745619491360","10067.73","-0.1","EURd","SWAP","PROCESSED","2023-05-17 21:12:49","","VIX","Volatility Index","",""
"28736495834777","10067.83","2.83","EURd","TRADE","PROCESSED","2023-05-17 18:47:48","0015421d-0055-311e-0000-4c26000b0df9_0015421d-0055-311e-0000-000080d8b8f9","ETH/USD","Ethereum / USD","",""
"28736495834776","10065","2","EURd","TRADE","PROCESSED","2023-05-17 18:47:48","0015421d-0055-311e-0000-4c26000b0df8_0015421d-0055-311e-0000-000080d8b8c8","ETH/USD","Ethereum / USD","",""
"28736495834775","10063","9.21","EURd","TRADE","PROCESSED","2023-05-17 18:47:48","0015421d-0055-311e-0000-4c26000b0df7_0015421d-0055-311e-0000-000080d8be15","ETH/USD","Ethereum / USD","",""
"28736495834774","10053.79","5.37","EURd","TRADE","PROCESSED","2023-05-17 18:47:48","0015421d-0055-311e-0000-4c26000b0df6_0015421d-0055-311e-0000-000080d8bb82","ETH/USD","Ethereum / USD","",""
"28736495834773","10048.42","7.48","EURd","TRADE","PROCESSED","2023-05-17 18:47:48","0015421d-0055-311e-0000-4c26000b0df5_0015421d-0055-311e-0000-000080d8bb58","ETH/USD","Ethereum / USD","",""
"28736495834772","10040.94","3.37","EURd","TRADE","PROCESSED","2023-05-17 18:47:48","0015421d-0055-311e-0000-4c26000b0df4_0015421d-0055-311e-0000-000080d8b9c9","ETH/USD","Ethereum / USD","",""
"28736475911764","10037.57","0.14","EURd","TRADE","PROCESSED","2023-05-17 18:47:29","0000a40d-0055-311e-0000-4c2600225ae5_0000a40d-0055-311e-0000-0000801d1304","JPM","JPMorgan Chase & Co (Extended Hours)","",""
"28735591958674","10037.43","0.06","EURd","TRADE","PROCESSED","2023-05-17 18:33:26","0015421d-0055-311e-0000-4c26000adfac_0015421d-0055-311e-0000-000080d8b88e","ETH/USD","Ethereum / USD","",""
"28733216940406","10037.37","3.64","EURd","TRADE","PROCESSED","2023-05-17 17:55:41","000940dd-0055-311e-0000-4c26001109c5_000940dd-0055-311e-0000-000081916510","BTC/USD","Bitcoin / USD","",""
"28733216940405","10033.73","1.38","EURd","TRADE","PROCESSED","2023-05-17 17:55:41","000940dd-0055-311e-0000-4c26001109c4_000940dd-0055-311e-0000-0000819164ba","BTC/USD","Bitcoin / USD","",""
"28733216940404","10032.35","1.31","EURd","TRADE","PROCESSED","2023-05-17 17:55:41","000940dd-0055-311e-0000-4c26001109c3_000940dd-0055-311e-0000-0000819164b2","BTC/USD","Bitcoin / USD","",""
"28733216940403","10031.04","5","EURd","TRADE","PROCESSED","2023-05-17 17:55:41","000940dd-0055-311e-0000-4c26001109c2_000940dd-0055-311e-0000-000081917007","BTC/USD","Bitcoin / USD","",""
"28732805896411","10026.04","1.99","EURd","TRADE","PROCESSED","2023-05-17 17:49:09","0004140c-0055-311e-0000-4c260010e063_0004140c-0055-311e-0000-0000804ceda9","AAPL","Apple Inc (Extended Hours)","",""
"28730349087716","10024.05","1.42","EURd","TRADE","PROCESSED","2023-05-17 17:10:06","0004140c-0055-311e-0000-4c2600101cd9_0004140c-0055-311e-0000-0000804ced22","AAPL","Apple Inc (Extended Hours)","",""
"28729396973527","10022.63","0.73","EURd","TRADE","PROCESSED","2023-05-17 16:54:58","00601567-0055-311e-0000-4c26001a7b42_00601567-0055-311e-0000-00008111f0e8","Gold","Gold","",""
"28728503595662","10021.9","2.56","EURd","TRADE","PROCESSED","2023-05-17 16:40:46","00353194-0055-311e-0000-4c2600181d8e_00353194-0055-311e-0000-0000801e1c40","MSFT","Microsoft Corp (Extended Hours)","",""
"28723940185241","10019.34","1.39","EURd","TRADE","PROCESSED","2023-05-17 15:28:14","00018387-0055-311e-0000-4c2600157880_00018387-0055-311e-0000-000080ce5fc5","Natural Gas","Natural Gas","",""
"28723156908473","10017.95","0.74","EURd","TRADE","PROCESSED","2023-05-17 15:15:47","00018387-0055-311e-0000-4c2600145ea0_00018387-0055-311e-0000-000080ce74ac","Natural Gas","Natural Gas","",""
"28723156908472","10017.21","0.89","EURd","TRADE","PROCESSED","2023-05-17 15:15:47","00018387-0055-311e-0000-4c2600145e9f_00018387-0055-311e-0000-000080ce7cd1","Natural Gas","Natural Gas","",""
"28722546634577","10016.32","2.07","EURd","TRADE","PROCESSED","2023-05-17 15:06:05","000940dd-0055-311e-0000-4c26000d6dc0_000940dd-0055-311e-0000-00008191755b","BTC/USD","Bitcoin / USD","",""
"28720616194417","10014.25","0.63","EURd","TRADE","PROCESSED","2023-05-17 14:35:24","00601567-0055-311e-0000-4c2600119f85_00601567-0055-311e-0000-00008111d342","Gold","Gold","",""
"28720613048665","10013.62","0.73","EURd","TRADE","PROCESSED","2023-05-17 14:35:21","00601567-0055-311e-0000-4c2600119e51_00601567-0055-311e-0000-00008111d5d7","Gold","Gold","",""
"28717221957140","10012.89","0.65","EURd","TRADE","PROCESSED","2023-05-17 13:41:27","000940dd-0055-311e-0000-4c26000a5f63_000940dd-0055-311e-0000-000081917373","BTC/USD","Bitcoin / USD","",""
"28717219859966","10012.24","0.22","EURd","TRADE","PROCESSED","2023-05-17 13:41:25","0015421d-0055-311e-0000-4c260007abc0_0015421d-0055-311e-0000-000080d8bc98","ETH/USD","Ethereum / USD","",""
"28717144361447","10012.02","0.95","EURd","TRADE","PROCESSED","2023-05-17 13:40:13","0015421d-0055-311e-0000-4c260007a909_0015421d-0055-311e-0000-000080d8bbd6","ETH/USD","Ethereum / USD","",""
"28714936057984","10011.07","0.02","EURd","TRADE","PROCESSED","2023-05-17 13:05:07","006011e7-0055-311e-0000-4c260009fa45_006011e7-0055-311e-0000-0000805bec28","Silver","Silver","",""
"28714161174083","10011.05","0.67","EURd","TRADE","PROCESSED","2023-05-17 12:52:48","00353194-0055-311e-0000-4c26000187c7_00353194-0055-311e-0000-0000801e1bb9","MSFT","Microsoft Corp (Extended Hours)","",""
"28714161174082","10010.38","0.35","EURd","TRADE","PROCESSED","2023-05-17 12:52:48","00353194-0055-311e-0000-4c26000187c6_00353194-0055-311e-0000-0000801e1bb4","MSFT","Microsoft Corp (Extended Hours)","",""
"28714161174080","10010.03","0.17","EURd","TRADE","PROCESSED","2023-05-17 12:52:48","00353194-0055-311e-0000-4c26000187c5_00353194-0055-311e-0000-0000801e1b93","MSFT","Microsoft Corp (Extended Hours)","",""
"28709996230094","10009.86","0.93","EURd","TRADE","PROCESSED","2023-05-17 11:46:36","006011e7-0055-311e-0000-4c26000878ec_006011e7-0055-311e-0000-0000805bec97","Silver","Silver","",""
"28709992035775","10008.93","2.08","EURd","TRADE","PROCESSED","2023-05-17 11:46:32","006011e7-0055-311e-0000-4c26000878ad_006011e7-0055-311e-0000-0000805bed54","Silver","Silver","",""
"28699624762919","10006.85","0.01","EURd","TRADE","PROCESSED","2023-05-17 09:01:45","0061241d-0055-311e-0000-4c260004eaf2_0061241d-0055-311e-0000-0000808a3bb0","XRP/USD","Ripple / USD","",""
"28696451775417","10006.84","1.6","EURd","TRADE","PROCESSED","2023-05-17 08:11:19","00082581-0015-549e-0000-4c2600036b1d_00082581-0015-549e-0000-0000801e0d57","BBVA","BBVA","",""
"28696224232949","10005.24","2.33","EURd","TRADE","PROCESSED","2023-05-17 08:07:42","00018509-0055-311e-0000-4c2600054be5_00018509-0055-311e-0000-000081140a8c","Oil - Crude","Crude Oil","",""
"28696224232947","10002.91","2.91","EURd","TRADE","PROCESSED","2023-05-17 08:07:42","00018509-0055-311e-0000-4c2600054be4_00018509-0055-311e-0000-00008114077b","Oil - Crude","Crude Oil","",""
"28690782115900","10000","9000","EURd","DEMO_TRANSFER","PROCESSED","2023-05-17 06:41:12","","","","",""
"28690761144350","1000","1000","EURd","DEMO_TRANSFER","PROCESSED","2023-05-17 06:40:52","","","","",""
